期号,日期,红球,蓝球,红球_1,红球_2,红球_3,红球_4,红球_5,蓝球_1,蓝球_2,red_sum,red_span,red_odd_count,red_even_count,blue_sum,blue_span,blue_odd_count,blue_even_count,red_zone1_count,red_zone2_count,red_zone3_count,blue_big_count,blue_small_count
7001,2007-05-30,"22,24,29,31,35","04,11",22,24,29,31,35,4,11,141,13,3,2,15,7,1,1,0,2,3,1,1
7002,2007-06-02,"15,22,31,34,35","05,12",15,22,31,34,35,5,12,137,20,3,2,17,7,1,1,0,2,3,1,1
7003,2007-06-04,"03,04,18,23,32","01,06",3,4,18,23,32,1,6,80,29,2,3,7,5,1,1,2,2,1,0,2
7004,2007-06-06,"06,10,16,17,25","02,04",6,10,16,17,25,2,4,74,19,2,3,6,2,0,2,2,2,1,0,2
7005,2007-06-09,"01,09,19,20,30","02,11",1,9,19,20,30,2,11,79,29,3,2,13,9,1,1,2,2,1,1,1
7006,2007-06-11,"01,16,20,23,28","03,06",1,16,20,23,28,3,6,88,27,2,3,9,3,1,1,1,3,1,0,2
7007,2007-06-13,"14,16,25,26,35","04,09",14,16,25,26,35,4,9,116,21,2,3,13,5,1,1,0,2,3,1,1
7008,2007-06-16,"02,08,11,21,23","04,07",2,8,11,21,23,4,7,65,21,3,2,11,3,1,1,3,2,0,1,1
7009,2007-06-18,"01,03,09,19,34","09,12",1,3,9,19,34,9,12,66,33,4,1,21,3,1,1,3,1,1,2,0
7010,2007-06-20,"06,08,18,29,34","09,11",6,8,18,29,34,9,11,95,28,1,4,20,2,2,0,2,1,2,2,0
7011,2007-06-23,"29,32,33,34,35","09,10",29,32,33,34,35,9,10,163,6,3,2,19,1,1,1,0,0,5,2,0
7012,2007-06-25,"03,12,15,29,34","07,11",3,12,15,29,34,7,11,93,31,3,2,18,4,2,0,2,1,2,2,0
7013,2007-06-27,"12,17,27,29,34","06,09",12,17,27,29,34,6,9,119,22,3,2,15,3,1,1,1,1,3,1,1
7014,2007-06-30,"01,02,07,29,32","06,07",1,2,7,29,32,6,7,71,31,3,2,13,1,1,1,3,0,2,1,1
7015,2007-07-02,"02,08,12,13,17","11,12",2,8,12,13,17,11,12,52,15,2,3,23,1,1,1,3,2,0,2,0
7016,2007-07-04,"01,14,19,24,31","03,12",1,14,19,24,31,3,12,89,30,3,2,15,9,1,1,1,3,1,1,1
7017,2007-07-07,"13,14,29,32,34","03,12",13,14,29,32,34,3,12,122,21,2,3,15,9,1,1,0,2,3,1,1
7018,2007-07-09,"03,04,16,23,28","06,09",3,4,16,23,28,6,9,74,25,2,3,15,3,1,1,2,2,1,1,1
7019,2007-07-11,"03,06,17,22,23","04,06",3,6,17,22,23,4,6,71,20,3,2,10,2,0,2,2,3,0,0,2
7020,2007-07-14,"02,06,11,12,18","05,12",2,6,11,12,18,5,12,49,16,1,4,17,7,1,1,4,1,0,1,1
7021,2007-07-16,"02,04,24,29,33","01,02",2,4,24,29,33,1,2,92,31,2,3,3,1,1,1,2,1,2,0,2
7022,2007-07-18,"08,10,12,23,25","03,10",8,10,12,23,25,3,10,78,17,2,3,13,7,1,1,3,1,1,1,1
7023,2007-07-21,"08,10,23,32,34","08,10",8,10,23,32,34,8,10,107,26,1,4,18,2,0,2,2,1,2,2,0
7024,2007-07-23,"06,16,20,25,31","04,09",6,16,20,25,31,4,9,98,25,2,3,13,5,1,1,1,2,2,1,1
7025,2007-07-25,"22,24,26,27,34","02,10",22,24,26,27,34,2,10,133,12,1,4,12,8,0,2,0,2,3,1,1
7026,2007-07-28,"05,09,13,33,35","01,08",5,9,13,33,35,1,8,95,30,5,0,9,7,1,1,2,1,2,1,1
7027,2007-07-30,"02,03,10,19,27","06,10",2,3,10,19,27,6,10,61,25,3,2,16,4,0,2,3,1,1,1,1
7028,2007-08-01,"20,26,30,34,35","03,10",20,26,30,34,35,3,10,145,15,1,4,13,7,1,1,0,1,4,1,1
7029,2007-08-04,"15,22,25,29,35","09,11",15,22,25,29,35,9,11,126,20,4,1,20,2,2,0,0,2,3,2,0
7030,2007-08-06,"11,14,27,33,35","02,07",11,14,27,33,35,2,7,120,24,4,1,9,5,1,1,1,1,3,1,1
7031,2007-08-08,"03,21,27,31,32","06,08",3,21,27,31,32,6,8,114,29,4,1,14,2,0,2,1,1,3,1,1
7032,2007-08-11,"01,13,21,23,32","04,11",1,13,21,23,32,4,11,90,31,4,1,15,7,1,1,1,3,1,1,1
7033,2007-08-13,"01,05,08,14,22","03,12",1,5,8,14,22,3,12,50,21,2,3,15,9,1,1,3,2,0,1,1
7034,2007-08-15,"06,08,11,13,22","02,11",6,8,11,13,22,2,11,60,16,2,3,13,9,1,1,3,2,0,1,1
7035,2007-08-18,"07,11,16,31,32","01,12",7,11,16,31,32,1,12,97,25,3,2,13,11,1,1,2,1,2,1,1
7036,2007-08-20,"15,18,21,27,34","01,02",15,18,21,27,34,1,2,115,19,3,2,3,1,1,1,0,3,2,0,2
7037,2007-08-22,"01,06,07,17,31","11,12",1,6,7,17,31,11,12,62,30,4,1,23,1,1,1,3,1,1,2,0
7038,2007-08-25,"06,21,25,27,32","08,09",6,21,25,27,32,8,9,111,26,3,2,17,1,1,1,1,1,3,2,0
7039,2007-08-27,"10,11,20,21,35","07,11",10,11,20,21,35,7,11,97,25,3,2,18,4,2,0,2,2,1,2,0
7040,2007-08-29,"05,21,25,28,35","01,04",5,21,25,28,35,1,4,114,30,4,1,5,3,1,1,1,1,3,0,2
7041,2007-09-01,"03,16,17,22,35","01,08",3,16,17,22,35,1,8,93,32,3,2,9,7,1,1,1,3,1,1,1
7042,2007-09-03,"07,10,22,31,35","05,06",7,10,22,31,35,5,6,105,28,3,2,11,1,1,1,2,1,2,0,2
7043,2007-09-05,"04,09,22,24,31","02,06",4,9,22,24,31,2,6,90,27,2,3,8,4,0,2,2,2,1,0,2
7044,2007-09-08,"04,05,07,12,26","01,10",4,5,7,12,26,1,10,54,22,2,3,11,9,1,1,4,0,1,1,1
7045,2007-09-10,"09,16,20,26,35","11,12",9,16,20,26,35,11,12,106,26,2,3,23,1,1,1,1,2,2,2,0
7046,2007-09-12,"04,16,18,23,30","01,10",4,16,18,23,30,1,10,91,26,1,4,11,9,1,1,1,3,1,1,1
7047,2007-09-15,"01,06,15,19,35","02,09",1,6,15,19,35,2,9,76,34,4,1,11,7,1,1,2,2,1,1,1
7048,2007-09-17,"08,25,26,29,35","06,08",8,25,26,29,35,6,8,123,27,3,2,14,2,0,2,1,0,4,1,1
7049,2007-09-19,"09,10,15,17,32","04,06",9,10,15,17,32,4,6,83,23,3,2,10,2,0,2,2,2,1,0,2
7050,2007-09-22,"13,21,22,30,35","01,11",13,21,22,30,35,1,11,121,22,3,2,12,10,2,0,0,3,2,1,1
7051,2007-09-24,"03,07,24,28,35","08,11",3,7,24,28,35,8,11,97,32,3,2,19,3,1,1,2,1,2,2,0
7052,2007-09-26,"01,14,29,32,33","05,10",1,14,29,32,33,5,10,109,32,3,2,15,5,1,1,1,1,3,1,1
7053,2007-09-29,"11,16,19,21,25","01,10",11,16,19,21,25,1,10,92,14,4,1,11,9,1,1,1,3,1,1,1
7054,2007-10-01,"04,10,19,29,34","03,06",4,10,19,29,34,3,6,96,30,2,3,9,3,1,1,2,1,2,0,2
7055,2007-10-03,"10,16,24,31,33","07,10",10,16,24,31,33,7,10,114,23,2,3,17,3,1,1,1,2,2,2,0
7056,2007-10-06,"04,11,17,20,21","05,09",4,11,17,20,21,5,9,73,17,3,2,14,4,2,0,2,3,0,1,1
7057,2007-10-08,"14,16,30,32,35","06,07",14,16,30,32,35,6,7,127,21,1,4,13,1,1,1,0,2,3,1,1
7058,2007-10-10,"08,21,25,28,33","02,06",8,21,25,28,33,2,6,115,25,3,2,8,4,0,2,1,1,3,0,2
7059,2007-10-13,"04,15,23,31,33","03,09",4,15,23,31,33,3,9,106,29,4,1,12,6,2,0,1,2,2,1,1
7060,2007-10-15,"12,13,29,30,31","04,07",12,13,29,30,31,4,7,115,19,3,2,11,3,1,1,1,1,3,1,1
7061,2007-10-17,"02,10,19,28,29","02,09",2,10,19,28,29,2,9,88,27,2,3,11,7,1,1,2,1,2,1,1
7062,2007-10-20,"01,04,10,14,29","11,12",1,4,10,14,29,11,12,58,28,2,3,23,1,1,1,3,1,1,2,0
7063,2007-10-22,"10,31,33,34,35","07,12",10,31,33,34,35,7,12,143,25,3,2,19,5,1,1,1,0,4,2,0
7064,2007-10-24,"02,16,32,33,35","05,10",2,16,32,33,35,5,10,118,33,2,3,15,5,1,1,1,1,3,1,1
7065,2007-10-27,"19,20,24,29,31","09,10",19,20,24,29,31,9,10,123,12,3,2,19,1,1,1,0,3,2,2,0
7066,2007-10-29,"04,07,08,19,24","07,12",4,7,8,19,24,7,12,62,20,2,3,19,5,1,1,3,2,0,2,0
7067,2007-10-31,"11,18,25,30,31","04,09",11,18,25,30,31,4,9,115,20,3,2,13,5,1,1,1,1,3,1,1
7068,2007-11-03,"04,09,13,14,33","06,10",4,9,13,14,33,6,10,73,29,3,2,16,4,0,2,2,2,1,1,1
7069,2007-11-05,"02,13,16,21,35","01,05",2,13,16,21,35,1,5,87,33,3,2,6,4,2,0,1,3,1,0,2
7070,2007-11-07,"07,26,29,30,35","03,04",7,26,29,30,35,3,4,127,28,3,2,7,1,1,1,1,0,4,0,2
7071,2007-11-10,"10,22,32,33,35","01,07",10,22,32,33,35,1,7,132,25,2,3,8,6,2,0,1,1,3,1,1
7072,2007-11-12,"21,24,26,27,33","01,05",21,24,26,27,33,1,5,131,12,3,2,6,4,2,0,0,2,3,0,2
7073,2007-11-14,"04,05,09,12,23","02,11",4,5,9,12,23,2,11,53,19,3,2,13,9,1,1,4,1,0,1,1
7074,2007-11-17,"16,17,23,24,31","05,10",16,17,23,24,31,5,10,111,15,3,2,15,5,1,1,0,4,1,1,1
7075,2007-11-19,"05,11,20,30,32","07,11",5,11,20,30,32,7,11,98,27,2,3,18,4,2,0,2,1,2,2,0
7076,2007-11-21,"02,09,12,15,31","09,10",2,9,12,15,31,9,10,69,29,3,2,19,1,1,1,3,1,1,2,0
7077,2007-11-24,"04,06,12,13,24","01,04",4,6,12,13,24,1,4,59,20,1,4,5,3,1,1,3,2,0,0,2
7078,2007-11-26,"09,12,14,22,23","01,02",9,12,14,22,23,1,2,80,14,2,3,3,1,1,1,2,3,0,0,2
7079,2007-11-28,"06,09,25,26,31","02,08",6,9,25,26,31,2,8,97,25,3,2,10,6,0,2,2,0,3,1,1
7080,2007-12-01,"01,15,20,25,27","05,10",1,15,20,25,27,5,10,88,26,4,1,15,5,1,1,1,2,2,1,1
7081,2007-12-03,"06,18,20,22,35","04,09",6,18,20,22,35,4,9,101,29,1,4,13,5,1,1,1,3,1,1,1
7082,2007-12-05,"03,05,14,33,34","07,08",3,5,14,33,34,7,8,89,31,3,2,15,1,1,1,2,1,2,2,0
7083,2007-12-08,"01,05,20,21,24","03,04",1,5,20,21,24,3,4,71,23,3,2,7,1,1,1,2,3,0,0,2
7084,2007-12-10,"05,11,18,29,34","10,11",5,11,18,29,34,10,11,97,29,3,2,21,1,1,1,2,1,2,2,0
7085,2007-12-12,"17,24,28,29,33","02,05",17,24,28,29,33,2,5,131,16,3,2,7,3,1,1,0,2,3,0,2
7086,2007-12-15,"14,18,19,26,28","03,09",14,18,19,26,28,3,9,105,14,1,4,12,6,2,0,0,3,2,1,1
7087,2007-12-17,"08,18,30,31,33","04,09",8,18,30,31,33,4,9,120,25,2,3,13,5,1,1,1,1,3,1,1
7088,2007-12-19,"17,18,21,23,33","06,10",17,18,21,23,33,6,10,112,16,4,1,16,4,0,2,0,4,1,1,1
7089,2007-12-22,"08,13,24,30,34","01,12",8,13,24,30,34,1,12,109,26,1,4,13,11,1,1,1,2,2,1,1
7090,2007-12-24,"04,20,24,31,33","09,12",4,20,24,31,33,9,12,112,29,2,3,21,3,1,1,1,2,2,2,0
7091,2007-12-26,"07,12,26,31,32","03,08",7,12,26,31,32,3,8,108,25,2,3,11,5,1,1,2,0,3,1,1
7092,2007-12-29,"06,19,27,28,29","06,10",6,19,27,28,29,6,10,109,23,3,2,16,4,0,2,1,1,3,1,1
7093,2007-12-31,"06,08,16,25,27","08,12",6,8,16,25,27,8,12,82,21,2,3,20,4,0,2,2,1,2,2,0
8001,2008-01-02,"01,02,11,34,35","03,10",1,2,11,34,35,3,10,83,34,3,2,13,7,1,1,3,0,2,1,1
8002,2008-01-05,"01,12,24,31,32","10,12",1,12,24,31,32,10,12,100,31,2,3,22,2,0,2,2,1,2,2,0
8003,2008-01-07,"01,11,13,32,35","02,07",1,11,13,32,35,2,7,92,34,4,1,9,5,1,1,2,1,2,1,1
8004,2008-01-09,"09,22,24,31,33","08,09",9,22,24,31,33,8,9,119,24,3,2,17,1,1,1,1,2,2,2,0
8005,2008-01-12,"18,25,29,31,34","09,10",18,25,29,31,34,9,10,137,16,3,2,19,1,1,1,0,1,4,2,0
8006,2008-01-14,"10,12,26,29,34","05,07",10,12,26,29,34,5,7,111,24,1,4,12,2,2,0,2,0,3,1,1
8007,2008-01-16,"03,04,05,12,28","03,12",3,4,5,12,28,3,12,52,25,2,3,15,9,1,1,4,0,1,1,1
8008,2008-01-19,"02,06,08,17,32","08,09",2,6,8,17,32,8,9,65,30,1,4,17,1,1,1,3,1,1,2,0
8009,2008-01-21,"04,08,12,24,30","05,08",4,8,12,24,30,5,8,78,26,0,5,13,3,1,1,3,1,1,1,1
8010,2008-01-23,"06,23,24,27,29","06,08",6,23,24,27,29,6,8,109,23,3,2,14,2,0,2,1,2,2,1,1
8011,2008-01-26,"14,20,22,24,27","07,10",14,20,22,24,27,7,10,107,13,1,4,17,3,1,1,0,4,1,2,0
8012,2008-01-28,"02,10,29,32,35","02,03",2,10,29,32,35,2,3,108,33,2,3,5,1,1,1,2,0,3,0,2
8013,2008-01-30,"01,11,19,22,35","05,09",1,11,19,22,35,5,9,88,34,4,1,14,4,2,0,2,2,1,1,1
8014,2008-02-02,"04,07,10,28,34","01,06",4,7,10,28,34,1,6,83,30,1,4,7,5,1,1,3,0,2,0,2
8015,2008-02-04,"09,18,20,27,33","06,09",9,18,20,27,33,6,9,107,24,3,2,15,3,1,1,1,2,2,1,1
8016,2008-02-13,"08,10,11,17,19","06,09",8,10,11,17,19,6,9,65,11,3,2,15,3,1,1,3,2,0,1,1
8017,2008-02-16,"02,14,25,29,32","01,06",2,14,25,29,32,1,6,102,30,2,3,7,5,1,1,1,1,3,0,2
8018,2008-02-18,"03,06,07,11,30","02,03",3,6,7,11,30,2,3,57,27,3,2,5,1,1,1,4,0,1,0,2
8019,2008-02-20,"08,24,25,29,31","04,05",8,24,25,29,31,4,5,117,23,3,2,9,1,1,1,1,1,3,0,2
8020,2008-02-23,"04,05,15,17,33","04,08",4,5,15,17,33,4,8,74,29,4,1,12,4,0,2,2,2,1,1,1
8021,2008-02-25,"05,10,13,21,24","04,09",5,10,13,21,24,4,9,73,19,3,2,13,5,1,1,2,3,0,1,1
8022,2008-02-27,"09,12,13,25,31","08,10",9,12,13,25,31,8,10,90,22,4,1,18,2,0,2,2,1,2,2,0
8023,2008-03-01,"06,26,31,32,34","07,10",6,26,31,32,34,7,10,129,28,1,4,17,3,1,1,1,0,4,2,0
8024,2008-03-03,"08,12,17,20,30","01,02",8,12,17,20,30,1,2,87,22,1,4,3,1,1,1,2,2,1,0,2
8025,2008-03-05,"06,10,12,15,28","04,12",6,10,12,15,28,4,12,71,22,1,4,16,8,0,2,3,1,1,1,1
8026,2008-03-08,"01,21,22,24,25","08,10",1,21,22,24,25,8,10,93,24,3,2,18,2,0,2,1,3,1,2,0
8027,2008-03-10,"05,17,23,31,32","04,08",5,17,23,31,32,4,8,108,27,4,1,12,4,0,2,1,2,2,1,1
8028,2008-03-12,"03,11,17,19,26","07,12",3,11,17,19,26,7,12,76,23,4,1,19,5,1,1,2,2,1,2,0
8029,2008-03-15,"06,11,18,29,30","04,11",6,11,18,29,30,4,11,94,24,2,3,15,7,1,1,2,1,2,1,1
8030,2008-03-17,"03,21,23,26,35","05,08",3,21,23,26,35,5,8,108,32,4,1,13,3,1,1,1,2,2,1,1
8031,2008-03-19,"14,20,23,27,28","02,04",14,20,23,27,28,2,4,112,14,2,3,6,2,0,2,0,3,2,0,2
8032,2008-03-22,"03,09,19,27,33","09,10",3,9,19,27,33,9,10,91,30,5,0,19,1,1,1,2,1,2,2,0
8033,2008-03-24,"03,10,21,23,30","01,09",3,10,21,23,30,1,9,87,27,3,2,10,8,2,0,2,2,1,1,1
8034,2008-03-26,"06,07,18,34,35","05,10",6,7,18,34,35,5,10,100,29,2,3,15,5,1,1,2,1,2,1,1
8035,2008-03-29,"02,12,13,29,30","05,07",2,12,13,29,30,5,7,86,28,2,3,12,2,2,0,2,1,2,1,1
8036,2008-03-31,"09,19,22,30,32","01,10",9,19,22,30,32,1,10,112,23,2,3,11,9,1,1,1,2,2,1,1
8037,2008-04-02,"11,20,24,31,35","04,10",11,20,24,31,35,4,10,121,24,3,2,14,6,0,2,1,2,2,1,1
8038,2008-04-05,"12,13,19,32,33","02,10",12,13,19,32,33,2,10,109,21,3,2,12,8,0,2,1,2,2,1,1
8039,2008-04-07,"07,11,15,27,35","04,07",7,11,15,27,35,4,7,95,28,5,0,11,3,1,1,2,1,2,1,1
8040,2008-04-09,"04,08,19,22,29","08,11",4,8,19,22,29,8,11,82,25,2,3,19,3,1,1,2,2,1,2,0
8041,2008-04-12,"07,17,21,22,28","05,10",7,17,21,22,28,5,10,95,21,3,2,15,5,1,1,1,3,1,1,1
8042,2008-04-14,"05,10,13,32,35","04,05",5,10,13,32,35,4,5,95,30,3,2,9,1,1,1,2,1,2,0,2
8043,2008-04-16,"05,08,10,31,33","02,04",5,8,10,31,33,2,4,87,28,3,2,6,2,0,2,3,0,2,0,2
8044,2008-04-19,"02,21,23,27,32","10,11",2,21,23,27,32,10,11,105,30,3,2,21,1,1,1,1,2,2,2,0
8045,2008-04-21,"14,32,33,34,35","02,04",14,32,33,34,35,2,4,148,21,2,3,6,2,0,2,0,1,4,0,2
8046,2008-04-23,"11,25,26,27,35","07,08",11,25,26,27,35,7,8,124,24,4,1,15,1,1,1,1,0,4,2,0
8047,2008-04-26,"12,18,22,23,30","06,12",12,18,22,23,30,6,12,105,18,1,4,18,6,0,2,1,3,1,1,1
8048,2008-04-28,"01,13,22,25,27","02,10",1,13,22,25,27,2,10,88,26,4,1,12,8,0,2,1,2,2,1,1
8049,2008-04-30,"01,11,14,28,30","03,10",1,11,14,28,30,3,10,84,29,2,3,13,7,1,1,2,1,2,1,1
8050,2008-05-03,"01,05,11,26,27","03,07",1,5,11,26,27,3,7,70,26,4,1,10,4,2,0,3,0,2,1,1
8051,2008-05-05,"01,07,09,11,33","03,11",1,7,9,11,33,3,11,61,32,5,0,14,8,2,0,4,0,1,1,1
8052,2008-05-07,"03,18,19,30,35","05,09",3,18,19,30,35,5,9,105,32,3,2,14,4,2,0,1,2,2,1,1
8053,2008-05-10,"01,13,21,23,32","03,06",1,13,21,23,32,3,6,90,31,4,1,9,3,1,1,1,3,1,0,2
8054,2008-05-12,"05,14,23,31,35","02,06",5,14,23,31,35,2,6,108,30,4,1,8,4,0,2,1,2,2,0,2
8055,2008-05-14,"02,14,28,30,35","04,12",2,14,28,30,35,4,12,109,33,1,4,16,8,0,2,1,1,3,1,1
8056,2008-05-17,"15,19,25,30,31","03,09",15,19,25,30,31,3,9,120,16,4,1,12,6,2,0,0,2,3,1,1
8057,2008-05-19,"05,08,09,17,33","05,06",5,8,9,17,33,5,6,72,28,4,1,11,1,1,1,3,1,1,0,2
8058,2008-05-21,"03,09,11,29,33","03,12",3,9,11,29,33,3,12,85,30,5,0,15,9,1,1,3,0,2,1,1
8059,2008-05-24,"07,13,21,25,31","08,10",7,13,21,25,31,8,10,97,24,5,0,18,2,0,2,1,2,2,2,0
8060,2008-05-26,"03,13,17,23,30","01,11",3,13,17,23,30,1,11,86,27,4,1,12,10,2,0,1,3,1,1,1
8061,2008-05-28,"07,10,14,19,32","03,06",7,10,14,19,32,3,6,82,25,2,3,9,3,1,1,2,2,1,0,2
8062,2008-05-31,"01,15,27,28,29","03,10",1,15,27,28,29,3,10,100,28,4,1,13,7,1,1,1,1,3,1,1
8063,2008-06-02,"07,11,24,30,35","06,08",7,11,24,30,35,6,8,107,28,3,2,14,2,0,2,2,1,2,1,1
8064,2008-06-04,"14,18,24,27,31","06,07",14,18,24,27,31,6,7,114,17,2,3,13,1,1,1,0,3,2,1,1
8065,2008-06-07,"19,22,23,25,32","06,12",19,22,23,25,32,6,12,121,13,3,2,18,6,0,2,0,3,2,1,1
8066,2008-06-09,"02,07,21,22,25","04,12",2,7,21,22,25,4,12,77,23,3,2,16,8,0,2,2,2,1,1,1
8067,2008-06-11,"03,10,14,15,22","04,07",3,10,14,15,22,4,7,64,19,2,3,11,3,1,1,2,3,0,1,1
8068,2008-06-14,"06,09,11,33,34","06,10",6,9,11,33,34,6,10,93,28,3,2,16,4,0,2,3,0,2,1,1
8069,2008-06-16,"05,13,16,29,33","06,08",5,13,16,29,33,6,8,96,28,4,1,14,2,0,2,1,2,2,1,1
8070,2008-06-18,"09,17,18,21,31","01,05",9,17,18,21,31,1,5,96,22,4,1,6,4,2,0,1,3,1,0,2
8071,2008-06-21,"01,05,11,14,25","01,09",1,5,11,14,25,1,9,56,24,4,1,10,8,2,0,3,1,1,1,1
8072,2008-06-23,"10,25,32,33,34","03,09",10,25,32,33,34,3,9,134,24,2,3,12,6,2,0,1,0,4,1,1
8073,2008-06-25,"02,05,06,07,31","08,10",2,5,6,7,31,8,10,51,29,3,2,18,2,0,2,4,0,1,2,0
8074,2008-06-28,"10,13,22,31,35","04,12",10,13,22,31,35,4,12,111,25,3,2,16,8,0,2,1,2,2,1,1
8075,2008-06-30,"01,10,13,30,33","06,07",1,10,13,30,33,6,7,87,32,3,2,13,1,1,1,2,1,2,1,1
8076,2008-07-02,"03,05,10,27,34","01,12",3,5,10,27,34,1,12,79,31,3,2,13,11,1,1,3,0,2,1,1
8077,2008-07-05,"01,08,21,33,34","05,07",1,8,21,33,34,5,7,97,33,3,2,12,2,2,0,2,1,2,1,1
8078,2008-07-07,"08,17,20,28,31","07,11",8,17,20,28,31,7,11,104,23,2,3,18,4,2,0,1,2,2,2,0
8079,2008-07-09,"20,23,26,32,33","05,12",20,23,26,32,33,5,12,134,13,2,3,17,7,1,1,0,2,3,1,1
8080,2008-07-12,"06,09,29,31,33","05,11",6,9,29,31,33,5,11,108,27,4,1,16,6,2,0,2,0,3,1,1
8081,2008-07-14,"07,08,20,22,29","04,07",7,8,20,22,29,4,7,86,22,2,3,11,3,1,1,2,2,1,1,1
8082,2008-07-16,"15,19,29,33,35","01,02",15,19,29,33,35,1,2,131,20,5,0,3,1,1,1,0,2,3,0,2
8083,2008-07-19,"06,14,15,30,31","03,10",6,14,15,30,31,3,10,96,25,2,3,13,7,1,1,1,2,2,1,1
8084,2008-07-21,"02,17,20,22,25","05,11",2,17,20,22,25,5,11,86,23,2,3,16,6,2,0,1,3,1,1,1
8085,2008-07-23,"03,07,13,15,19","02,10",3,7,13,15,19,2,10,57,16,5,0,12,8,0,2,2,3,0,1,1
8086,2008-07-26,"01,06,10,22,35","03,07",1,6,10,22,35,3,7,74,34,2,3,10,4,2,0,3,1,1,1,1
8087,2008-07-28,"14,22,32,33,35","01,05",14,22,32,33,35,1,5,136,21,2,3,6,4,2,0,0,2,3,0,2
8088,2008-07-30,"07,11,19,27,31","02,03",7,11,19,27,31,2,3,95,24,5,0,5,1,1,1,2,1,2,0,2
8089,2008-08-02,"08,13,24,32,33","03,09",8,13,24,32,33,3,9,110,25,2,3,12,6,2,0,1,2,2,1,1
8090,2008-08-04,"04,11,18,33,34","02,06",4,11,18,33,34,2,6,100,30,2,3,8,4,0,2,2,1,2,0,2
8091,2008-08-06,"09,13,19,22,25","04,10",9,13,19,22,25,4,10,88,16,4,1,14,6,0,2,1,3,1,1,1
8092,2008-08-09,"03,23,26,32,34","04,09",3,23,26,32,34,4,9,118,31,2,3,13,5,1,1,1,1,3,1,1
8093,2008-08-11,"06,07,10,24,30","05,08",6,7,10,24,30,5,8,77,24,1,4,13,3,1,1,3,1,1,1,1
8094,2008-08-13,"07,12,19,27,34","11,12",7,12,19,27,34,11,12,99,27,3,2,23,1,1,1,2,1,2,2,0
8095,2008-08-16,"03,04,11,21,25","01,07",3,4,11,21,25,1,7,64,22,4,1,8,6,2,0,3,1,1,1,1
8096,2008-08-18,"06,07,12,25,28","02,12",6,7,12,25,28,2,12,78,22,2,3,14,10,0,2,3,0,2,1,1
8097,2008-08-20,"01,10,31,33,35","03,10",1,10,31,33,35,3,10,110,34,4,1,13,7,1,1,2,0,3,1,1
8098,2008-08-23,"07,10,22,27,33","04,08",7,10,22,27,33,4,8,99,26,3,2,12,4,0,2,2,1,2,1,1
8099,2008-08-25,"03,18,23,25,30","06,10",3,18,23,25,30,6,10,99,27,3,2,16,4,0,2,1,2,2,1,1
8100,2008-08-27,"12,20,26,29,30","02,06",12,20,26,29,30,2,6,117,18,1,4,8,4,0,2,1,1,3,0,2
8101,2008-08-30,"10,13,23,31,33","04,11",10,13,23,31,33,4,11,110,23,4,1,15,7,1,1,1,2,2,1,1
8102,2008-09-01,"05,25,26,29,35","03,10",5,25,26,29,35,3,10,120,30,4,1,13,7,1,1,1,0,4,1,1
8103,2008-09-03,"02,11,22,30,34","04,09",2,11,22,30,34,4,9,99,32,1,4,13,5,1,1,2,1,2,1,1
8104,2008-09-06,"07,08,10,24,34","08,11",7,8,10,24,34,8,11,83,27,1,4,19,3,1,1,3,1,1,2,0
8105,2008-09-08,"12,21,22,26,35","04,05",12,21,22,26,35,4,5,116,23,2,3,9,1,1,1,1,2,2,0,2
8106,2008-09-10,"03,05,21,28,33","02,06",3,5,21,28,33,2,6,90,30,4,1,8,4,0,2,2,1,2,0,2
8107,2008-09-13,"01,02,13,15,16","04,09",1,2,13,15,16,4,9,47,15,3,2,13,5,1,1,2,3,0,1,1
8108,2008-09-15,"11,16,24,29,32","09,11",11,16,24,29,32,9,11,112,21,2,3,20,2,2,0,1,2,2,2,0
8109,2008-09-17,"01,10,18,28,34","05,08",1,10,18,28,34,5,8,91,33,1,4,13,3,1,1,2,1,2,1,1
8110,2008-09-20,"05,16,25,27,33","04,09",5,16,25,27,33,4,9,106,28,4,1,13,5,1,1,1,1,3,1,1
8111,2008-09-22,"02,11,12,14,19","05,09",2,11,12,14,19,5,9,58,17,2,3,14,4,2,0,3,2,0,1,1
8112,2008-09-24,"04,18,26,32,33","05,08",4,18,26,32,33,5,8,113,29,1,4,13,3,1,1,1,1,3,1,1
8113,2008-09-27,"11,14,17,19,22","01,08",11,14,17,19,22,1,8,83,11,3,2,9,7,1,1,1,4,0,1,1
8114,2008-09-29,"02,03,22,27,31","06,07",2,3,22,27,31,6,7,85,29,3,2,13,1,1,1,2,1,2,1,1
8115,2008-10-01,"07,09,19,21,33","07,10",7,9,19,21,33,7,10,89,26,5,0,17,3,1,1,2,2,1,2,0
8116,2008-10-04,"06,08,15,24,31","01,03",6,8,15,24,31,1,3,84,25,2,3,4,2,2,0,2,2,1,0,2
8117,2008-10-06,"13,23,24,25,30","02,08",13,23,24,25,30,2,8,115,17,3,2,10,6,0,2,0,3,2,1,1
8118,2008-10-08,"06,09,19,25,30","06,12",6,9,19,25,30,6,12,89,24,3,2,18,6,0,2,2,1,2,1,1
8119,2008-10-11,"01,02,10,19,27","01,11",1,2,10,19,27,1,11,59,26,3,2,12,10,2,0,3,1,1,1,1
8120,2008-10-13,"21,23,24,25,32","03,04",21,23,24,25,32,3,4,125,11,3,2,7,1,1,1,0,3,2,0,2
8121,2008-10-15,"11,23,24,32,35","04,10",11,23,24,32,35,4,10,125,24,3,2,14,6,0,2,1,2,2,1,1
8122,2008-10-18,"03,06,12,20,29","09,12",3,6,12,20,29,9,12,70,26,2,3,21,3,1,1,3,1,1,2,0
8123,2008-10-20,"01,06,12,28,31","08,09",1,6,12,28,31,8,9,78,30,2,3,17,1,1,1,3,0,2,2,0
8124,2008-10-22,"02,10,13,29,33","06,10",2,10,13,29,33,6,10,87,31,3,2,16,4,0,2,2,1,2,1,1
8125,2008-10-25,"01,04,28,33,34","06,11",1,4,28,33,34,6,11,100,33,2,3,17,5,1,1,2,0,3,1,1
8126,2008-10-27,"09,29,32,34,35","01,08",9,29,32,34,35,1,8,139,26,3,2,9,7,1,1,1,0,4,1,1
8127,2008-10-29,"08,21,22,31,33","01,07",8,21,22,31,33,1,7,115,25,3,2,8,6,2,0,1,2,2,1,1
8128,2008-11-01,"12,15,23,24,25","10,11",12,15,23,24,25,10,11,99,13,3,2,21,1,1,1,1,3,1,2,0
8129,2008-11-03,"13,16,20,25,27","04,05",13,16,20,25,27,4,5,101,14,3,2,9,1,1,1,0,3,2,0,2
8130,2008-11-05,"03,05,22,29,34","07,12",3,5,22,29,34,7,12,93,31,3,2,19,5,1,1,2,1,2,2,0
8131,2008-11-08,"08,09,12,21,32","07,11",8,9,12,21,32,7,11,82,24,2,3,18,4,2,0,3,1,1,2,0
8132,2008-11-10,"06,14,24,27,29","05,09",6,14,24,27,29,5,9,100,23,2,3,14,4,2,0,1,2,2,1,1
8133,2008-11-12,"10,12,15,33,35","03,09",10,12,15,33,35,3,9,105,25,3,2,12,6,2,0,2,1,2,1,1
8134,2008-11-15,"11,13,15,28,35","08,10",11,13,15,28,35,8,10,102,24,4,1,18,2,0,2,1,2,2,2,0
8135,2008-11-17,"07,22,25,29,33","01,12",7,22,25,29,33,1,12,116,26,4,1,13,11,1,1,1,1,3,1,1
8136,2008-11-19,"03,28,29,32,34","01,06",3,28,29,32,34,1,6,126,31,2,3,7,5,1,1,1,0,4,0,2
8137,2008-11-22,"01,10,25,32,35","05,09",1,10,25,32,35,5,9,103,34,3,2,14,4,2,0,2,0,3,1,1
8138,2008-11-24,"04,05,18,22,35","07,08",4,5,18,22,35,7,8,84,31,2,3,15,1,1,1,2,2,1,2,0
8139,2008-11-26,"01,06,10,14,22","06,08",1,6,10,14,22,6,8,53,21,1,4,14,2,0,2,3,2,0,1,1
8140,2008-11-29,"02,09,11,29,32","08,09",2,9,11,29,32,8,9,83,30,3,2,17,1,1,1,3,0,2,2,0
8141,2008-12-01,"09,15,18,30,34","04,05",9,15,18,30,34,4,5,106,25,2,3,9,1,1,1,1,2,2,0,2
8142,2008-12-03,"06,18,21,30,35","08,09",6,18,21,30,35,8,9,110,29,2,3,17,1,1,1,1,2,2,2,0
8143,2008-12-06,"01,02,22,29,32","01,04",1,2,22,29,32,1,4,86,31,2,3,5,3,1,1,2,1,2,0,2
8144,2008-12-08,"10,19,27,28,33","05,12",10,19,27,28,33,5,12,117,23,3,2,17,7,1,1,1,1,3,1,1
8145,2008-12-10,"05,16,27,29,30","05,11",5,16,27,29,30,5,11,107,25,3,2,16,6,2,0,1,1,3,1,1
8146,2008-12-13,"09,23,24,26,33","07,12",9,23,24,26,33,7,12,115,24,3,2,19,5,1,1,1,2,2,2,0
8147,2008-12-15,"16,18,19,24,35","11,12",16,18,19,24,35,11,12,112,19,2,3,23,1,1,1,0,4,1,2,0
8148,2008-12-17,"03,07,20,33,35","04,07",3,7,20,33,35,4,7,98,32,4,1,11,3,1,1,2,1,2,1,1
8149,2008-12-20,"02,05,06,27,29","03,04",2,5,6,27,29,3,4,69,27,3,2,7,1,1,1,3,0,2,0,2
8150,2008-12-22,"01,09,10,15,25","03,08",1,9,10,15,25,3,8,60,24,4,1,11,5,1,1,3,1,1,1,1
8151,2008-12-24,"07,10,27,31,34","08,09",7,10,27,31,34,8,9,109,27,3,2,17,1,1,1,2,0,3,2,0
8152,2008-12-27,"03,05,14,20,33","07,11",3,5,14,20,33,7,11,75,30,3,2,18,4,2,0,2,2,1,2,0
8153,2008-12-29,"02,04,06,25,26","02,05",2,4,6,25,26,2,5,63,24,1,4,7,3,1,1,3,0,2,0,2
8154,2008-12-31,"05,07,10,29,32","04,06",5,7,10,29,32,4,6,83,27,3,2,10,2,0,2,3,0,2,0,2
9001,2009-01-03,"01,15,23,27,30","04,10",1,15,23,27,30,4,10,96,29,4,1,14,6,0,2,1,2,2,1,1
9002,2009-01-05,"01,04,07,12,30","05,10",1,4,7,12,30,5,10,54,29,2,3,15,5,1,1,4,0,1,1,1
9003,2009-01-07,"16,18,23,30,32","02,11",16,18,23,30,32,2,11,119,16,1,4,13,9,1,1,0,3,2,1,1
9004,2009-01-10,"01,03,22,32,35","06,10",1,3,22,32,35,6,10,93,34,3,2,16,4,0,2,2,1,2,1,1
9005,2009-01-12,"10,11,15,31,32","05,08",10,11,15,31,32,5,8,99,22,3,2,13,3,1,1,2,1,2,1,1
9006,2009-01-14,"02,04,22,31,35","09,12",2,4,22,31,35,9,12,94,33,2,3,21,3,1,1,2,1,2,2,0
9007,2009-01-17,"06,14,15,29,35","06,11",6,14,15,29,35,6,11,99,29,3,2,17,5,1,1,1,2,2,1,1
9008,2009-01-19,"04,17,21,29,31","02,12",4,17,21,29,31,2,12,102,27,4,1,14,10,0,2,1,2,2,1,1
9009,2009-01-21,"12,18,23,26,32","06,09",12,18,23,26,32,6,9,111,20,1,4,15,3,1,1,1,2,2,1,1
9010,2009-01-24,"02,09,12,21,29","07,11",2,9,12,21,29,7,11,73,27,3,2,18,4,2,0,3,1,1,2,0
9011,2009-02-02,"02,11,13,14,21","02,04",2,11,13,14,21,2,4,61,19,3,2,6,2,0,2,2,3,0,0,2
9012,2009-02-04,"02,05,20,25,31","10,12",2,5,20,25,31,10,12,83,29,3,2,22,2,0,2,2,1,2,2,0
9013,2009-02-07,"05,24,26,30,35","05,12",5,24,26,30,35,5,12,120,30,2,3,17,7,1,1,1,1,3,1,1
9014,2009-02-09,"08,14,15,25,26","07,09",8,14,15,25,26,7,9,88,18,2,3,16,2,2,0,1,2,2,2,0
9015,2009-02-11,"01,05,10,16,27","03,04",1,5,10,16,27,3,4,59,26,3,2,7,1,1,1,3,1,1,0,2
9016,2009-02-14,"10,11,20,26,27","09,11",10,11,20,26,27,9,11,94,17,2,3,20,2,2,0,2,1,2,2,0
9017,2009-02-16,"05,11,23,26,33","04,12",5,11,23,26,33,4,12,98,28,4,1,16,8,0,2,2,1,2,1,1
9018,2009-02-18,"01,06,13,28,29","03,09",1,6,13,28,29,3,9,77,28,3,2,12,6,2,0,2,1,2,1,1
9019,2009-02-21,"04,29,31,32,35","04,10",4,29,31,32,35,4,10,131,31,3,2,14,6,0,2,1,0,4,1,1
9020,2009-02-23,"05,16,18,32,35","02,11",5,16,18,32,35,2,11,106,30,2,3,13,9,1,1,1,2,2,1,1
9021,2009-02-25,"01,15,31,32,34","03,08",1,15,31,32,34,3,8,113,33,3,2,11,5,1,1,1,1,3,1,1
9022,2009-02-28,"12,14,17,34,35","04,11",12,14,17,34,35,4,11,112,23,2,3,15,7,1,1,1,2,2,1,1
9023,2009-03-02,"15,17,21,27,33","07,11",15,17,21,27,33,7,11,113,18,5,0,18,4,2,0,0,3,2,2,0
9024,2009-03-04,"29,31,32,33,35","10,11",29,31,32,33,35,10,11,160,6,4,1,21,1,1,1,0,0,5,2,0
9025,2009-03-07,"03,17,22,23,33","04,10",3,17,22,23,33,4,10,98,30,4,1,14,6,0,2,1,3,1,1,1
9026,2009-03-09,"24,30,31,32,34","10,12",24,30,31,32,34,10,12,151,10,1,4,22,2,0,2,0,1,4,2,0
9027,2009-03-11,"03,22,26,33,34","09,10",3,22,26,33,34,9,10,118,31,2,3,19,1,1,1,1,1,3,2,0
9028,2009-03-14,"06,20,30,32,35","09,11",6,20,30,32,35,9,11,123,29,1,4,20,2,2,0,1,1,3,2,0
9029,2009-03-16,"03,04,13,17,24","04,11",3,4,13,17,24,4,11,61,21,3,2,15,7,1,1,2,3,0,1,1
9030,2009-03-18,"01,07,27,30,32","01,04",1,7,27,30,32,1,4,97,31,3,2,5,3,1,1,2,0,3,0,2
9031,2009-03-21,"07,11,19,21,22","01,11",7,11,19,21,22,1,11,80,15,4,1,12,10,2,0,2,3,0,1,1
9032,2009-03-23,"04,12,20,26,29","06,10",4,12,20,26,29,6,10,91,25,1,4,16,4,0,2,2,1,2,1,1
9033,2009-03-25,"02,08,18,21,32","08,11",2,8,18,21,32,8,11,81,30,1,4,19,3,1,1,2,2,1,2,0
9034,2009-03-28,"05,19,31,32,35","04,09",5,19,31,32,35,4,9,122,30,4,1,13,5,1,1,1,1,3,1,1
9035,2009-03-30,"03,07,09,28,33","03,08",3,7,9,28,33,3,8,80,30,4,1,11,5,1,1,3,0,2,1,1
9036,2009-04-01,"02,12,26,31,33","09,10",2,12,26,31,33,9,10,104,31,2,3,19,1,1,1,2,0,3,2,0
9037,2009-04-04,"17,18,19,25,31","01,11",17,18,19,25,31,1,11,110,14,4,1,12,10,2,0,0,3,2,1,1
9038,2009-04-06,"06,17,20,29,32","04,05",6,17,20,29,32,4,5,104,26,2,3,9,1,1,1,1,2,2,0,2
9039,2009-04-08,"01,03,07,10,33","03,04",1,3,7,10,33,3,4,54,32,4,1,7,1,1,1,4,0,1,0,2
9040,2009-04-11,"03,16,30,32,33","01,10",3,16,30,32,33,1,10,114,30,2,3,11,9,1,1,1,1,3,1,1
9041,2009-04-13,"05,09,20,23,29","04,10",5,9,20,23,29,4,10,86,24,4,1,14,6,0,2,2,2,1,1,1
9042,2009-04-15,"11,24,25,26,31","02,07",11,24,25,26,31,2,7,117,20,3,2,9,5,1,1,1,1,3,1,1
9043,2009-04-18,"05,21,22,32,35","02,05",5,21,22,32,35,2,5,115,30,3,2,7,3,1,1,1,2,2,0,2
9044,2009-04-20,"01,07,18,29,34","03,09",1,7,18,29,34,3,9,89,33,3,2,12,6,2,0,2,1,2,1,1
9045,2009-04-22,"01,09,14,24,35","06,09",1,9,14,24,35,6,9,83,34,3,2,15,3,1,1,2,2,1,1,1
9046,2009-04-25,"01,09,24,34,35","04,09",1,9,24,34,35,4,9,103,34,3,2,13,5,1,1,2,1,2,1,1
9047,2009-04-27,"13,18,21,24,29","03,06",13,18,21,24,29,3,6,105,16,3,2,9,3,1,1,0,4,1,0,2
9048,2009-04-29,"05,06,22,25,27","11,12",5,6,22,25,27,11,12,85,22,3,2,23,1,1,1,2,1,2,2,0
9049,2009-05-02,"05,16,28,29,34","11,12",5,16,28,29,34,11,12,112,29,2,3,23,1,1,1,1,1,3,2,0
9050,2009-05-04,"05,15,28,32,33","08,09",5,15,28,32,33,8,9,113,28,3,2,17,1,1,1,1,1,3,2,0
9051,2009-05-06,"03,11,22,26,29","05,12",3,11,22,26,29,5,12,91,26,3,2,17,7,1,1,2,1,2,1,1
9052,2009-05-09,"23,24,30,34,35","01,03",23,24,30,34,35,1,3,146,12,2,3,4,2,2,0,0,2,3,0,2
9053,2009-05-11,"05,09,24,31,33","05,06",5,9,24,31,33,5,6,102,28,4,1,11,1,1,1,2,1,2,0,2
9054,2009-05-13,"02,12,19,29,30","07,12",2,12,19,29,30,7,12,92,28,2,3,19,5,1,1,2,1,2,2,0
9055,2009-05-16,"05,08,14,23,24","05,06",5,8,14,23,24,5,6,74,19,2,3,11,1,1,1,2,3,0,0,2
9056,2009-05-18,"04,13,17,32,35","03,06",4,13,17,32,35,3,6,101,31,3,2,9,3,1,1,1,2,2,0,2
9057,2009-05-20,"06,15,22,27,30","02,09",6,15,22,27,30,2,9,100,24,2,3,11,7,1,1,1,2,2,1,1
9058,2009-05-23,"08,10,14,27,32","02,07",8,10,14,27,32,2,7,91,24,1,4,9,5,1,1,2,1,2,1,1
9059,2009-05-25,"02,13,14,29,33","04,11",2,13,14,29,33,4,11,91,31,3,2,15,7,1,1,1,2,2,1,1
9060,2009-05-27,"18,28,29,30,31","04,08",18,28,29,30,31,4,8,136,13,2,3,12,4,0,2,0,1,4,1,1
9061,2009-05-30,"02,10,21,26,34","02,10",2,10,21,26,34,2,10,93,32,1,4,12,8,0,2,2,1,2,1,1
9062,2009-06-01,"04,22,23,29,31","05,11",4,22,23,29,31,5,11,109,27,3,2,16,6,2,0,1,2,2,1,1
9063,2009-06-03,"05,06,18,21,22","01,07",5,6,18,21,22,1,7,72,17,2,3,8,6,2,0,2,3,0,1,1
9064,2009-06-06,"06,10,11,17,34","11,12",6,10,11,17,34,11,12,78,28,2,3,23,1,1,1,3,1,1,2,0
9065,2009-06-08,"01,12,24,27,32","02,11",1,12,24,27,32,2,11,96,31,2,3,13,9,1,1,2,1,2,1,1
9066,2009-06-10,"01,08,19,24,31","06,12",1,8,19,24,31,6,12,83,30,3,2,18,6,0,2,2,2,1,1,1
9067,2009-06-13,"03,06,25,28,32","02,05",3,6,25,28,32,2,5,94,29,2,3,7,3,1,1,2,0,3,0,2
9068,2009-06-15,"02,12,15,20,28","01,12",2,12,15,20,28,1,12,77,26,1,4,13,11,1,1,2,2,1,1,1
9069,2009-06-17,"14,16,27,30,33","08,12",14,16,27,30,33,8,12,120,19,2,3,20,4,0,2,0,2,3,2,0
9070,2009-06-20,"10,21,24,30,31","03,10",10,21,24,30,31,3,10,116,21,2,3,13,7,1,1,1,2,2,1,1
9071,2009-06-22,"04,20,29,30,33","02,11",4,20,29,30,33,2,11,116,29,2,3,13,9,1,1,1,1,3,1,1
9072,2009-06-24,"23,26,29,32,33","05,10",23,26,29,32,33,5,10,143,10,3,2,15,5,1,1,0,1,4,1,1
9073,2009-06-27,"01,10,19,21,30","01,04",1,10,19,21,30,1,4,81,29,3,2,5,3,1,1,2,2,1,0,2
9074,2009-06-29,"15,17,19,23,32","01,11",15,17,19,23,32,1,11,106,17,4,1,12,10,2,0,0,4,1,1,1
9075,2009-07-01,"01,07,11,32,33","09,11",1,7,11,32,33,9,11,84,32,4,1,20,2,2,0,3,0,2,2,0
9076,2009-07-04,"03,09,11,18,24","04,05",3,9,11,18,24,4,5,65,21,3,2,9,1,1,1,3,2,0,0,2
9077,2009-07-06,"07,20,28,32,34","06,08",7,20,28,32,34,6,8,121,27,1,4,14,2,0,2,1,1,3,1,1
9078,2009-07-08,"11,23,26,31,34","05,11",11,23,26,31,34,5,11,125,23,3,2,16,6,2,0,1,1,3,1,1
9079,2009-07-11,"01,02,07,13,34","04,10",1,2,7,13,34,4,10,57,33,3,2,14,6,0,2,3,1,1,1,1
9080,2009-07-13,"07,16,19,29,35","02,11",7,16,19,29,35,2,11,106,28,4,1,13,9,1,1,1,2,2,1,1
9081,2009-07-15,"02,15,20,25,33","03,06",2,15,20,25,33,3,6,95,31,3,2,9,3,1,1,1,2,2,0,2
9082,2009-07-18,"05,11,26,29,32","08,11",5,11,26,29,32,8,11,103,27,3,2,19,3,1,1,2,0,3,2,0
9083,2009-07-20,"02,05,28,34,35","01,07",2,5,28,34,35,1,7,104,33,2,3,8,6,2,0,2,0,3,1,1
9084,2009-07-22,"05,09,19,26,35","02,10",5,9,19,26,35,2,10,94,30,4,1,12,8,0,2,2,1,2,1,1
9085,2009-07-25,"06,13,27,33,34","09,12",6,13,27,33,34,9,12,113,28,3,2,21,3,1,1,1,1,3,2,0
9086,2009-07-27,"01,02,07,26,29","10,12",1,2,7,26,29,10,12,65,28,3,2,22,2,0,2,3,0,2,2,0
9087,2009-07-29,"10,24,28,30,33","01,10",10,24,28,30,33,1,10,125,23,1,4,11,9,1,1,1,1,3,1,1
9088,2009-08-01,"13,16,27,32,34","03,09",13,16,27,32,34,3,9,122,21,2,3,12,6,2,0,0,2,3,1,1
9089,2009-08-03,"03,06,11,19,27","02,07",3,6,11,19,27,2,7,66,24,4,1,9,5,1,1,3,1,1,1,1
9090,2009-08-05,"18,25,30,33,34","04,10",18,25,30,33,34,4,10,140,16,2,3,14,6,0,2,0,1,4,1,1
9091,2009-08-08,"01,05,17,32,34","03,07",1,5,17,32,34,3,7,89,33,3,2,10,4,2,0,2,1,2,1,1
9092,2009-08-10,"10,21,22,27,29","08,12",10,21,22,27,29,8,12,109,19,3,2,20,4,0,2,1,2,2,2,0
9093,2009-08-12,"07,09,22,30,33","09,11",7,9,22,30,33,9,11,101,26,3,2,20,2,2,0,2,1,2,2,0
9094,2009-08-15,"01,05,21,23,29","05,12",1,5,21,23,29,5,12,79,28,5,0,17,7,1,1,2,2,1,1,1
9095,2009-08-17,"08,18,24,30,33","01,06",8,18,24,30,33,1,6,113,25,1,4,7,5,1,1,1,2,2,0,2
9096,2009-08-19,"07,12,28,32,33","01,03",7,12,28,32,33,1,3,112,26,2,3,4,2,2,0,2,0,3,0,2
9097,2009-08-22,"06,13,14,22,25","01,04",6,13,14,22,25,1,4,80,19,2,3,5,3,1,1,1,3,1,0,2
9098,2009-08-24,"11,17,19,25,26","02,10",11,17,19,25,26,2,10,98,15,4,1,12,8,0,2,1,2,2,1,1
9099,2009-08-26,"03,09,21,23,33","06,10",3,9,21,23,33,6,10,89,30,5,0,16,4,0,2,2,2,1,1,1
9100,2009-08-29,"16,20,25,29,33","01,08",16,20,25,29,33,1,8,123,17,3,2,9,7,1,1,0,2,3,1,1
9101,2009-08-31,"02,10,14,22,26","04,09",2,10,14,22,26,4,9,74,24,0,5,13,5,1,1,2,2,1,1,1
9102,2009-09-02,"11,13,29,32,35","10,12",11,13,29,32,35,10,12,120,24,4,1,22,2,0,2,1,1,3,2,0
9103,2009-09-05,"16,20,28,32,33","01,02",16,20,28,32,33,1,2,129,17,1,4,3,1,1,1,0,2,3,0,2
9104,2009-09-07,"15,25,29,32,33","10,11",15,25,29,32,33,10,11,134,18,4,1,21,1,1,1,0,1,4,2,0
9105,2009-09-09,"01,25,26,34,35","06,11",1,25,26,34,35,6,11,121,34,3,2,17,5,1,1,1,0,4,1,1
9106,2009-09-12,"11,21,22,25,34","06,09",11,21,22,25,34,6,9,113,23,3,2,15,3,1,1,1,2,2,1,1
9107,2009-09-14,"11,12,33,34,35","01,10",11,12,33,34,35,1,10,125,24,3,2,11,9,1,1,2,0,3,1,1
9108,2009-09-16,"01,09,14,29,30","07,10",1,9,14,29,30,7,10,83,29,3,2,17,3,1,1,2,1,2,2,0
9109,2009-09-19,"02,11,13,26,35","06,10",2,11,13,26,35,6,10,87,33,3,2,16,4,0,2,2,1,2,1,1
9110,2009-09-21,"22,28,30,31,34","07,09",22,28,30,31,34,7,9,145,12,1,4,16,2,2,0,0,1,4,2,0
9111,2009-09-23,"04,11,13,19,35","10,12",4,11,13,19,35,10,12,82,31,4,1,22,2,0,2,2,2,1,2,0
9112,2009-09-26,"02,08,12,34,35","04,05",2,8,12,34,35,4,5,91,33,1,4,9,1,1,1,3,0,2,0,2
9113,2009-09-28,"03,04,10,18,27","06,08",3,4,10,18,27,6,8,62,24,2,3,14,2,0,2,3,1,1,1,1
9114,2009-09-30,"02,08,25,29,33","03,07",2,8,25,29,33,3,7,97,31,3,2,10,4,2,0,2,0,3,1,1
9115,2009-10-03,"01,02,06,08,26","05,12",1,2,6,8,26,5,12,43,25,1,4,17,7,1,1,4,0,1,1,1
9116,2009-10-05,"12,15,23,30,33","09,12",12,15,23,30,33,9,12,113,21,3,2,21,3,1,1,1,2,2,2,0
9117,2009-10-07,"07,21,29,31,33","09,10",7,21,29,31,33,9,10,121,26,5,0,19,1,1,1,1,1,3,2,0
9118,2009-10-10,"10,17,18,21,34","05,11",10,17,18,21,34,5,11,100,24,2,3,16,6,2,0,1,3,1,1,1
9119,2009-10-12,"03,12,22,23,28","04,12",3,12,22,23,28,4,12,88,25,2,3,16,8,0,2,2,2,1,1,1
9120,2009-10-14,"11,23,27,28,32","02,05",11,23,27,28,32,2,5,121,21,3,2,7,3,1,1,1,1,3,0,2
9121,2009-10-17,"04,05,08,11,22","02,10",4,5,8,11,22,2,10,50,18,2,3,12,8,0,2,4,1,0,1,1
9122,2009-10-19,"01,02,11,31,33","05,06",1,2,11,31,33,5,6,78,32,4,1,11,1,1,1,3,0,2,0,2
9123,2009-10-21,"10,21,28,29,32","06,10",10,21,28,29,32,6,10,120,22,2,3,16,4,0,2,1,1,3,1,1
9124,2009-10-24,"01,03,14,32,35","07,11",1,3,14,32,35,7,11,85,34,3,2,18,4,2,0,2,1,2,2,0
9125,2009-10-26,"08,20,23,29,31","02,11",8,20,23,29,31,2,11,111,23,3,2,13,9,1,1,1,2,2,1,1
9126,2009-10-28,"14,23,27,28,33","08,12",14,23,27,28,33,8,12,125,19,3,2,20,4,0,2,0,2,3,2,0
9127,2009-10-31,"05,09,27,32,34","05,08",5,9,27,32,34,5,8,107,29,3,2,13,3,1,1,2,0,3,1,1
9128,2009-11-02,"06,21,28,32,34","04,07",6,21,28,32,34,4,7,121,28,1,4,11,3,1,1,1,1,3,1,1
9129,2009-11-04,"02,10,18,32,33","03,08",2,10,18,32,33,3,8,95,31,1,4,11,5,1,1,2,1,2,1,1
9130,2009-11-07,"09,14,25,32,34","02,08",9,14,25,32,34,2,8,114,25,2,3,10,6,0,2,1,1,3,1,1
9131,2009-11-09,"02,03,08,33,34","03,11",2,3,8,33,34,3,11,80,32,2,3,14,8,2,0,3,0,2,1,1
9132,2009-11-11,"02,10,12,15,28","04,07",2,10,12,15,28,4,7,67,26,1,4,11,3,1,1,3,1,1,1,1
9133,2009-11-14,"01,08,24,27,34","10,11",1,8,24,27,34,10,11,94,33,2,3,21,1,1,1,2,1,2,2,0
9134,2009-11-16,"02,16,19,28,33","07,11",2,16,19,28,33,7,11,98,31,2,3,18,4,2,0,1,2,2,2,0
9135,2009-11-18,"06,08,15,20,32","05,06",6,8,15,20,32,5,6,81,26,1,4,11,1,1,1,2,2,1,0,2
9136,2009-11-21,"07,13,23,24,29","06,10",7,13,23,24,29,6,10,96,22,4,1,16,4,0,2,1,3,1,1,1
9137,2009-11-23,"12,28,29,30,34","01,09",12,28,29,30,34,1,9,133,22,1,4,10,8,2,0,1,0,4,1,1
9138,2009-11-25,"03,04,14,28,32","09,10",3,4,14,28,32,9,10,81,29,1,4,19,1,1,1,2,1,2,2,0
9139,2009-11-28,"14,16,20,22,32","05,09",14,16,20,22,32,5,9,104,18,0,5,14,4,2,0,0,4,1,1,1
9140,2009-11-30,"07,08,19,26,30","01,12",7,8,19,26,30,1,12,90,23,2,3,13,11,1,1,2,1,2,1,1
9141,2009-12-02,"13,14,21,30,33","02,08",13,14,21,30,33,2,8,111,20,3,2,10,6,0,2,0,3,2,1,1
9142,2009-12-05,"05,06,13,24,31","03,11",5,6,13,24,31,3,11,79,26,3,2,14,8,2,0,2,2,1,1,1
9143,2009-12-07,"01,09,10,11,22","01,12",1,9,10,11,22,1,12,53,21,3,2,13,11,1,1,4,1,0,1,1
9144,2009-12-09,"18,26,32,33,34","04,06",18,26,32,33,34,4,6,143,16,1,4,10,2,0,2,0,1,4,0,2
9145,2009-12-12,"05,11,14,22,35","03,10",5,11,14,22,35,3,10,87,30,3,2,13,7,1,1,2,2,1,1,1
9146,2009-12-14,"11,17,23,24,25","03,06",11,17,23,24,25,3,6,100,14,4,1,9,3,1,1,1,3,1,0,2
9147,2009-12-16,"06,12,18,22,29","05,08",6,12,18,22,29,5,8,87,23,1,4,13,3,1,1,2,2,1,1,1
9148,2009-12-19,"02,04,13,14,33","01,09",2,4,13,14,33,1,9,66,31,2,3,10,8,2,0,2,2,1,1,1
9149,2009-12-21,"01,03,10,12,20","02,07",1,3,10,12,20,2,7,46,19,2,3,9,5,1,1,4,1,0,1,1
9150,2009-12-23,"04,11,18,25,34","05,07",4,11,18,25,34,5,7,92,30,2,3,12,2,2,0,2,1,2,1,1
9151,2009-12-26,"03,08,14,30,31","04,09",3,8,14,30,31,4,9,86,28,2,3,13,5,1,1,2,1,2,1,1
9152,2009-12-28,"01,23,29,30,32","07,12",1,23,29,30,32,7,12,115,31,3,2,19,5,1,1,1,1,3,2,0
9153,2009-12-30,"21,22,30,32,34","03,07",21,22,30,32,34,3,7,139,13,1,4,10,4,2,0,0,2,3,1,1
10001,2010-01-02,"02,06,07,12,27","02,08",2,6,7,12,27,2,8,54,25,2,3,10,6,0,2,4,0,1,1,1
10002,2010-01-04,"04,23,25,26,30","07,10",4,23,25,26,30,7,10,108,26,2,3,17,3,1,1,1,1,3,2,0
10003,2010-01-06,"05,14,23,27,30","02,08",5,14,23,27,30,2,8,99,25,3,2,10,6,0,2,1,2,2,1,1
10004,2010-01-09,"03,06,21,24,34","04,06",3,6,21,24,34,4,6,88,31,2,3,10,2,0,2,2,2,1,0,2
10005,2010-01-11,"04,17,19,22,30","02,03",4,17,19,22,30,2,3,92,26,2,3,5,1,1,1,1,3,1,0,2
10006,2010-01-13,"03,13,19,30,34","02,05",3,13,19,30,34,2,5,99,31,3,2,7,3,1,1,1,2,2,0,2
10007,2010-01-16,"07,23,26,29,32","08,11",7,23,26,29,32,8,11,117,25,3,2,19,3,1,1,1,1,3,2,0
10008,2010-01-18,"11,23,25,31,32","05,11",11,23,25,31,32,5,11,122,21,4,1,16,6,2,0,1,1,3,1,1
10009,2010-01-20,"02,05,13,27,32","03,11",2,5,13,27,32,3,11,79,30,3,2,14,8,2,0,2,1,2,1,1
10010,2010-01-23,"15,22,24,32,35","02,09",15,22,24,32,35,2,9,128,20,2,3,11,7,1,1,0,3,2,1,1
10011,2010-01-25,"02,03,11,27,32","08,11",2,3,11,27,32,8,11,75,30,3,2,19,3,1,1,3,0,2,2,0
10012,2010-01-27,"20,24,30,31,33","05,12",20,24,30,31,33,5,12,138,13,2,3,17,7,1,1,0,2,3,1,1
10013,2010-01-30,"18,21,22,26,34","09,12",18,21,22,26,34,9,12,121,16,1,4,21,3,1,1,0,3,2,2,0
10014,2010-02-01,"18,19,30,33,35","02,04",18,19,30,33,35,2,4,135,17,3,2,6,2,0,2,0,2,3,0,2
10015,2010-02-03,"03,10,14,18,28","08,10",3,10,14,18,28,8,10,73,25,1,4,18,2,0,2,2,2,1,2,0
10016,2010-02-06,"10,12,20,23,32","04,10",10,12,20,23,32,4,10,97,22,1,4,14,6,0,2,2,2,1,1,1
10017,2010-02-08,"13,21,23,27,34","09,12",13,21,23,27,34,9,12,118,21,4,1,21,3,1,1,0,3,2,2,0
10018,2010-02-10,"03,10,26,32,33","04,12",3,10,26,32,33,4,12,104,30,2,3,16,8,0,2,2,0,3,1,1
10019,2010-02-20,"03,11,19,26,27","02,09",3,11,19,26,27,2,9,86,24,4,1,11,7,1,1,2,1,2,1,1
10020,2010-02-22,"08,18,26,32,33","01,06",8,18,26,32,33,1,6,117,25,1,4,7,5,1,1,1,1,3,0,2
10021,2010-02-24,"11,20,23,24,25","07,09",11,20,23,24,25,7,9,103,14,3,2,16,2,2,0,1,3,1,2,0
10022,2010-02-27,"02,11,13,14,25","02,05",2,11,13,14,25,2,5,65,23,3,2,7,3,1,1,2,2,1,0,2
10023,2010-03-01,"11,13,29,32,33","02,08",11,13,29,32,33,2,8,118,22,4,1,10,6,0,2,1,1,3,1,1
10024,2010-03-03,"03,14,19,24,25","04,11",3,14,19,24,25,4,11,85,22,3,2,15,7,1,1,1,3,1,1,1
10025,2010-03-06,"09,11,13,14,25","01,07",9,11,13,14,25,1,7,72,16,4,1,8,6,2,0,2,2,1,1,1
10026,2010-03-08,"05,23,25,31,35","07,10",5,23,25,31,35,7,10,119,30,5,0,17,3,1,1,1,1,3,2,0
10027,2010-03-10,"05,23,26,32,34","02,09",5,23,26,32,34,2,9,120,29,2,3,11,7,1,1,1,1,3,1,1
10028,2010-03-13,"01,02,07,20,35","01,03",1,2,7,20,35,1,3,65,34,3,2,4,2,2,0,3,1,1,0,2
10029,2010-03-15,"21,22,33,34,35","03,04",21,22,33,34,35,3,4,145,14,3,2,7,1,1,1,0,2,3,0,2
10030,2010-03-17,"10,12,19,32,35","02,07",10,12,19,32,35,2,7,108,25,2,3,9,5,1,1,2,1,2,1,1
10031,2010-03-20,"05,13,16,17,35","06,08",5,13,16,17,35,6,8,86,30,4,1,14,2,0,2,1,3,1,1,1
10032,2010-03-22,"13,16,23,24,33","07,11",13,16,23,24,33,7,11,109,20,3,2,18,4,2,0,0,4,1,2,0
10033,2010-03-24,"12,19,28,29,30","05,08",12,19,28,29,30,5,8,118,18,2,3,13,3,1,1,1,1,3,1,1
10034,2010-03-27,"01,06,19,25,26","03,09",1,6,19,25,26,3,9,77,25,3,2,12,6,2,0,2,1,2,1,1
10035,2010-03-29,"14,16,20,31,34","01,07",14,16,20,31,34,1,7,115,20,1,4,8,6,2,0,0,3,2,1,1
10036,2010-03-31,"19,25,28,31,33","01,08",19,25,28,31,33,1,8,136,14,4,1,9,7,1,1,0,1,4,1,1
10037,2010-04-03,"19,21,26,34,35","01,09",19,21,26,34,35,1,9,135,16,3,2,10,8,2,0,0,2,3,1,1
10038,2010-04-05,"08,10,25,29,33","01,02",8,10,25,29,33,1,2,105,25,3,2,3,1,1,1,2,0,3,0,2
10039,2010-04-07,"07,19,26,28,32","01,08",7,19,26,28,32,1,8,112,25,2,3,9,7,1,1,1,1,3,1,1
10040,2010-04-10,"13,20,26,31,35","02,11",13,20,26,31,35,2,11,125,22,3,2,13,9,1,1,0,2,3,1,1
10041,2010-04-12,"16,22,28,29,34","04,12",16,22,28,29,34,4,12,129,18,1,4,16,8,0,2,0,2,3,1,1
10042,2010-04-14,"01,05,19,34,35","06,07",1,5,19,34,35,6,7,94,34,4,1,13,1,1,1,2,1,2,1,1
10043,2010-04-17,"05,08,10,33,35","02,10",5,8,10,33,35,2,10,91,30,3,2,12,8,0,2,3,0,2,1,1
10044,2010-04-19,"06,21,24,28,30","02,07",6,21,24,28,30,2,7,109,24,1,4,9,5,1,1,1,2,2,1,1
10045,2010-04-21,"08,17,18,20,28","09,10",8,17,18,20,28,9,10,91,20,1,4,19,1,1,1,1,3,1,2,0
10046,2010-04-24,"02,15,19,26,27","05,06",2,15,19,26,27,5,6,89,25,3,2,11,1,1,1,1,2,2,0,2
10047,2010-04-26,"04,08,11,30,31","02,08",4,8,11,30,31,2,8,84,27,2,3,10,6,0,2,3,0,2,1,1
10048,2010-04-28,"02,03,10,12,25","03,09",2,3,10,12,25,3,9,52,23,2,3,12,6,2,0,4,0,1,1,1
10049,2010-05-01,"01,25,29,31,33","04,10",1,25,29,31,33,4,10,119,32,5,0,14,6,0,2,1,0,4,1,1
10050,2010-05-03,"07,08,15,30,35","05,10",7,8,15,30,35,5,10,95,28,3,2,15,5,1,1,2,1,2,1,1
10051,2010-05-05,"06,10,20,24,32","06,10",6,10,20,24,32,6,10,92,26,0,5,16,4,0,2,2,2,1,1,1
10052,2010-05-08,"04,06,25,29,32","05,06",4,6,25,29,32,5,6,96,28,2,3,11,1,1,1,2,0,3,0,2
10053,2010-05-10,"09,19,22,26,34","09,11",9,19,22,26,34,9,11,110,25,2,3,20,2,2,0,1,2,2,2,0
10054,2010-05-12,"12,25,29,30,33","10,11",12,25,29,30,33,10,11,129,21,3,2,21,1,1,1,1,0,4,2,0
10055,2010-05-15,"13,14,17,27,32","02,10",13,14,17,27,32,2,10,103,19,3,2,12,8,0,2,0,3,2,1,1
10056,2010-05-17,"05,09,23,25,30","09,12",5,9,23,25,30,9,12,92,25,4,1,21,3,1,1,2,1,2,2,0
10057,2010-05-19,"15,17,24,32,35","07,09",15,17,24,32,35,7,9,123,20,3,2,16,2,2,0,0,3,2,2,0
10058,2010-05-22,"06,15,17,19,30","01,12",6,15,17,19,30,1,12,87,24,3,2,13,11,1,1,1,3,1,1,1
10059,2010-05-24,"06,10,14,25,34","01,03",6,10,14,25,34,1,3,89,28,1,4,4,2,2,0,2,1,2,0,2
10060,2010-05-26,"10,13,22,33,34","01,05",10,13,22,33,34,1,5,112,24,2,3,6,4,2,0,1,2,2,0,2
10061,2010-05-29,"05,12,14,17,22","05,07",5,12,14,17,22,5,7,70,17,2,3,12,2,2,0,2,3,0,1,1
10062,2010-05-31,"06,07,18,30,31","07,08",6,7,18,30,31,7,8,92,25,2,3,15,1,1,1,2,1,2,2,0
10063,2010-06-02,"07,14,16,30,31","03,06",7,14,16,30,31,3,6,98,24,2,3,9,3,1,1,1,2,2,0,2
10064,2010-06-05,"07,10,12,20,21","06,09",7,10,12,20,21,6,9,70,14,2,3,15,3,1,1,3,2,0,1,1
10065,2010-06-07,"05,08,13,14,32","08,11",5,8,13,14,32,8,11,72,27,2,3,19,3,1,1,2,2,1,2,0
10066,2010-06-09,"15,21,22,24,27","01,06",15,21,22,24,27,1,6,109,12,3,2,7,5,1,1,0,4,1,0,2
10067,2010-06-12,"01,11,19,30,32","03,10",1,11,19,30,32,3,10,93,31,3,2,13,7,1,1,2,1,2,1,1
10068,2010-06-14,"11,17,19,20,34","06,10",11,17,19,20,34,6,10,101,23,3,2,16,4,0,2,1,3,1,1,1
10069,2010-06-16,"06,17,18,25,29","08,09",6,17,18,25,29,8,9,95,23,3,2,17,1,1,1,1,2,2,2,0
10070,2010-06-19,"05,14,23,25,28","11,12",5,14,23,25,28,11,12,95,23,3,2,23,1,1,1,1,2,2,2,0
10071,2010-06-21,"07,12,26,30,32","02,07",7,12,26,30,32,2,7,107,25,1,4,9,5,1,1,2,0,3,1,1
10072,2010-06-23,"05,10,17,23,25","03,10",5,10,17,23,25,3,10,80,20,4,1,13,7,1,1,2,2,1,1,1
10073,2010-06-26,"04,09,11,30,32","01,11",4,9,11,30,32,1,11,86,28,2,3,12,10,2,0,3,0,2,1,1
10074,2010-06-28,"03,07,20,27,32","02,12",3,7,20,27,32,2,12,89,29,3,2,14,10,0,2,2,1,2,1,1
10075,2010-06-30,"10,12,17,23,27","05,07",10,12,17,23,27,5,7,89,17,3,2,12,2,2,0,2,2,1,1,1
10076,2010-07-03,"09,12,16,19,35","02,12",9,12,16,19,35,2,12,91,26,3,2,14,10,0,2,2,2,1,1,1
10077,2010-07-05,"06,07,09,17,24","02,12",6,7,9,17,24,2,12,63,18,3,2,14,10,0,2,3,2,0,1,1
10078,2010-07-07,"02,03,15,28,35","01,11",2,3,15,28,35,1,11,83,33,3,2,12,10,2,0,2,1,2,1,1
10079,2010-07-10,"01,04,21,22,24","02,05",1,4,21,22,24,2,5,72,23,2,3,7,3,1,1,2,3,0,0,2
10080,2010-07-12,"08,19,27,29,34","04,10",8,19,27,29,34,4,10,117,26,3,2,14,6,0,2,1,1,3,1,1
10081,2010-07-14,"14,18,20,24,27","05,10",14,18,20,24,27,5,10,103,13,1,4,15,5,1,1,0,4,1,1,1
10082,2010-07-17,"05,08,24,29,30","04,06",5,8,24,29,30,4,6,96,25,2,3,10,2,0,2,2,1,2,0,2
10083,2010-07-19,"07,11,21,22,35","04,07",7,11,21,22,35,4,7,96,28,4,1,11,3,1,1,2,2,1,1,1
10084,2010-07-21,"03,13,14,22,26","02,05",3,13,14,22,26,2,5,78,23,2,3,7,3,1,1,1,3,1,0,2
10085,2010-07-24,"02,10,16,18,34","02,03",2,10,16,18,34,2,3,80,32,0,5,5,1,1,1,2,2,1,0,2
10086,2010-07-26,"01,02,12,19,35","05,07",1,2,12,19,35,5,7,69,34,3,2,12,2,2,0,3,1,1,1,1
10087,2010-07-28,"01,12,20,21,24","02,08",1,12,20,21,24,2,8,78,23,2,3,10,6,0,2,2,3,0,1,1
10088,2010-07-31,"03,05,14,30,35","03,06",3,5,14,30,35,3,6,87,32,3,2,9,3,1,1,2,1,2,0,2
10089,2010-08-02,"04,10,13,18,23","08,10",4,10,13,18,23,8,10,68,19,2,3,18,2,0,2,2,3,0,2,0
10090,2010-08-04,"08,24,26,31,32","07,09",8,24,26,31,32,7,9,121,24,1,4,16,2,2,0,1,1,3,2,0
10091,2010-08-07,"06,10,23,26,31","05,07",6,10,23,26,31,5,7,96,25,2,3,12,2,2,0,2,1,2,1,1
10092,2010-08-09,"02,15,29,30,34","02,12",2,15,29,30,34,2,12,110,32,2,3,14,10,0,2,1,1,3,1,1
10093,2010-08-11,"02,04,09,28,29","05,08",2,4,9,28,29,5,8,72,27,2,3,13,3,1,1,3,0,2,1,1
10094,2010-08-14,"20,32,33,34,35","06,07",20,32,33,34,35,6,7,154,15,2,3,13,1,1,1,0,1,4,1,1
10095,2010-08-16,"12,14,16,19,25","01,06",12,14,16,19,25,1,6,86,13,2,3,7,5,1,1,1,3,1,0,2
10096,2010-08-18,"04,09,24,30,35","01,10",4,9,24,30,35,1,10,102,31,2,3,11,9,1,1,2,1,2,1,1
10097,2010-08-21,"09,17,21,28,29","02,08",9,17,21,28,29,2,8,104,20,4,1,10,6,0,2,1,2,2,1,1
10098,2010-08-23,"02,03,12,13,25","01,07",2,3,12,13,25,1,7,55,23,3,2,8,6,2,0,3,1,1,1,1
10099,2010-08-25,"03,11,17,21,30","01,08",3,11,17,21,30,1,8,82,27,4,1,9,7,1,1,2,2,1,1,1
10100,2010-08-28,"19,20,30,33,35","06,08",19,20,30,33,35,6,8,137,16,3,2,14,2,0,2,0,2,3,1,1
10101,2010-08-30,"11,15,22,27,35","05,08",11,15,22,27,35,5,8,110,24,4,1,13,3,1,1,1,2,2,1,1
10102,2010-09-01,"04,15,19,24,35","01,10",4,15,19,24,35,1,10,97,31,3,2,11,9,1,1,1,3,1,1,1
10103,2010-09-04,"10,14,29,30,35","05,08",10,14,29,30,35,5,8,118,25,2,3,13,3,1,1,1,1,3,1,1
10104,2010-09-06,"14,25,30,32,33","01,11",14,25,30,32,33,1,11,134,19,2,3,12,10,2,0,0,1,4,1,1
10105,2010-09-08,"05,17,26,27,35","08,09",5,17,26,27,35,8,9,110,30,4,1,17,1,1,1,1,1,3,2,0
10106,2010-09-11,"05,27,28,29,34","09,12",5,27,28,29,34,9,12,123,29,3,2,21,3,1,1,1,0,4,2,0
10107,2010-09-13,"14,17,22,27,34","03,05",14,17,22,27,34,3,5,114,20,2,3,8,2,2,0,0,3,2,0,2
10108,2010-09-15,"01,10,13,19,34","09,12",1,10,13,19,34,9,12,77,33,3,2,21,3,1,1,2,2,1,2,0
10109,2010-09-18,"01,02,08,11,25","10,12",1,2,8,11,25,10,12,47,24,3,2,22,2,0,2,4,0,1,2,0
10110,2010-09-20,"21,29,30,33,35","07,11",21,29,30,33,35,7,11,148,14,4,1,18,4,2,0,0,1,4,2,0
10111,2010-09-22,"03,06,13,14,29","01,02",3,6,13,14,29,1,2,65,26,3,2,3,1,1,1,2,2,1,0,2
10112,2010-09-25,"14,15,18,34,35","08,10",14,15,18,34,35,8,10,116,21,2,3,18,2,0,2,0,3,2,2,0
10113,2010-09-27,"05,16,22,23,32","04,10",5,16,22,23,32,4,10,98,27,2,3,14,6,0,2,1,3,1,1,1
10114,2010-09-29,"03,07,22,25,35","03,11",3,7,22,25,35,3,11,92,32,4,1,14,8,2,0,2,1,2,1,1
10115,2010-10-02,"05,07,10,15,32","03,08",5,7,10,15,32,3,8,69,27,3,2,11,5,1,1,3,1,1,1,1
10116,2010-10-04,"14,22,27,28,35","04,10",14,22,27,28,35,4,10,126,21,2,3,14,6,0,2,0,2,3,1,1
10117,2010-10-06,"04,06,21,27,34","05,09",4,6,21,27,34,5,9,92,30,2,3,14,4,2,0,2,1,2,1,1
10118,2010-10-09,"19,22,23,29,35","08,10",19,22,23,29,35,8,10,128,16,4,1,18,2,0,2,0,3,2,2,0
10119,2010-10-11,"05,13,14,23,26","02,03",5,13,14,23,26,2,3,81,21,3,2,5,1,1,1,1,3,1,0,2
10120,2010-10-13,"08,10,18,34,35","06,10",8,10,18,34,35,6,10,105,27,1,4,16,4,0,2,2,1,2,1,1
10121,2010-10-16,"21,22,31,32,34","02,12",21,22,31,32,34,2,12,140,13,2,3,14,10,0,2,0,2,3,1,1
10122,2010-10-18,"05,06,11,13,26","02,07",5,6,11,13,26,2,7,61,21,3,2,9,5,1,1,3,1,1,1,1
10123,2010-10-20,"18,20,30,32,33","01,11",18,20,30,32,33,1,11,133,15,1,4,12,10,2,0,0,2,3,1,1
10124,2010-10-23,"01,09,27,29,34","01,06",1,9,27,29,34,1,6,100,33,4,1,7,5,1,1,2,0,3,0,2
10125,2010-10-25,"01,07,09,14,19","09,12",1,7,9,14,19,9,12,50,18,4,1,21,3,1,1,3,2,0,2,0
10126,2010-10-27,"03,05,09,13,33","05,11",3,5,9,13,33,5,11,63,30,5,0,16,6,2,0,3,1,1,1,1
10127,2010-10-30,"03,22,24,30,33","04,10",3,22,24,30,33,4,10,112,30,2,3,14,6,0,2,1,2,2,1,1
10128,2010-11-01,"06,17,19,29,35","02,08",6,17,19,29,35,2,8,106,29,4,1,10,6,0,2,1,2,2,1,1
10129,2010-11-03,"14,15,24,25,26","03,07",14,15,24,25,26,3,7,104,12,2,3,10,4,2,0,0,3,2,1,1
10130,2010-11-06,"05,06,09,10,34","08,11",5,6,9,10,34,8,11,64,29,2,3,19,3,1,1,4,0,1,2,0
10131,2010-11-08,"10,15,22,28,29","04,12",10,15,22,28,29,4,12,104,19,2,3,16,8,0,2,1,2,2,1,1
10132,2010-11-10,"18,21,23,25,29","06,11",18,21,23,25,29,6,11,116,11,4,1,17,5,1,1,0,3,2,1,1
10133,2010-11-13,"11,16,17,21,22","03,06",11,16,17,21,22,3,6,87,11,3,2,9,3,1,1,1,4,0,0,2
10134,2010-11-15,"09,12,13,19,30","04,05",9,12,13,19,30,4,5,83,21,3,2,9,1,1,1,2,2,1,0,2
10135,2010-11-17,"14,17,19,26,32","03,04",14,17,19,26,32,3,4,108,18,2,3,7,1,1,1,0,3,2,0,2
10136,2010-11-20,"03,13,18,30,33","07,08",3,13,18,30,33,7,8,97,30,3,2,15,1,1,1,1,2,2,2,0
10137,2010-11-22,"22,27,28,33,35","09,11",22,27,28,33,35,9,11,145,13,3,2,20,2,2,0,0,1,4,2,0
10138,2010-11-24,"08,12,14,19,27","05,06",8,12,14,19,27,5,6,80,19,2,3,11,1,1,1,2,2,1,0,2
10139,2010-11-27,"03,13,16,19,29","07,09",3,13,16,19,29,7,9,80,26,4,1,16,2,2,0,1,3,1,2,0
10140,2010-11-29,"06,18,20,30,31","03,06",6,18,20,30,31,3,6,105,25,1,4,9,3,1,1,1,2,2,0,2
10141,2010-12-01,"05,11,17,23,33","03,10",5,11,17,23,33,3,10,89,28,5,0,13,7,1,1,2,2,1,1,1
10142,2010-12-04,"10,11,19,21,27","04,06",10,11,19,21,27,4,6,88,17,4,1,10,2,0,2,2,2,1,0,2
10143,2010-12-06,"10,16,18,22,27","06,08",10,16,18,22,27,6,8,93,17,1,4,14,2,0,2,1,3,1,1,1
10144,2010-12-08,"02,11,16,22,31","10,11",2,11,16,22,31,10,11,82,29,2,3,21,1,1,1,2,2,1,2,0
10145,2010-12-11,"18,19,27,28,33","03,06",18,19,27,28,33,3,6,125,15,3,2,9,3,1,1,0,2,3,0,2
10146,2010-12-13,"14,17,30,31,34","04,10",14,17,30,31,34,4,10,126,20,2,3,14,6,0,2,0,2,3,1,1
10147,2010-12-15,"01,15,19,21,23","11,12",1,15,19,21,23,11,12,79,22,5,0,23,1,1,1,1,4,0,2,0
10148,2010-12-18,"03,04,08,10,35","02,06",3,4,8,10,35,2,6,60,32,2,3,8,4,0,2,4,0,1,0,2
10149,2010-12-20,"05,22,24,25,30","01,06",5,22,24,25,30,1,6,106,25,2,3,7,5,1,1,1,2,2,0,2
10150,2010-12-22,"05,24,28,29,35","01,09",5,24,28,29,35,1,9,121,30,3,2,10,8,2,0,1,1,3,1,1
10151,2010-12-25,"01,10,32,33,35","03,08",1,10,32,33,35,3,8,111,34,3,2,11,5,1,1,2,0,3,1,1
10152,2010-12-27,"02,05,18,22,23","07,12",2,5,18,22,23,7,12,70,21,2,3,19,5,1,1,2,3,0,2,0
10153,2010-12-29,"06,07,16,24,35","04,06",6,7,16,24,35,4,6,88,29,2,3,10,2,0,2,2,2,1,0,2
11001,2011-01-01,"07,08,15,32,34","05,12",7,8,15,32,34,5,12,96,27,2,3,17,7,1,1,2,1,2,1,1
11002,2011-01-03,"11,13,27,28,29","02,06",11,13,27,28,29,2,6,108,18,4,1,8,4,0,2,1,1,3,0,2
11003,2011-01-05,"01,24,27,30,31","01,06",1,24,27,30,31,1,6,113,30,3,2,7,5,1,1,1,1,3,0,2
11004,2011-01-08,"07,08,10,23,25","07,09",7,8,10,23,25,7,9,73,18,3,2,16,2,2,0,3,1,1,2,0
11005,2011-01-10,"01,07,25,27,30","07,12",1,7,25,27,30,7,12,90,29,4,1,19,5,1,1,2,0,3,2,0
11006,2011-01-12,"02,08,16,26,35","11,12",2,8,16,26,35,11,12,87,33,1,4,23,1,1,1,2,1,2,2,0
11007,2011-01-15,"14,24,32,33,35","02,09",14,24,32,33,35,2,9,138,21,2,3,11,7,1,1,0,2,3,1,1
11008,2011-01-17,"01,23,26,27,30","05,06",1,23,26,27,30,5,6,107,29,3,2,11,1,1,1,1,1,3,0,2
11009,2011-01-19,"09,10,11,14,24","03,08",9,10,11,14,24,3,8,68,15,2,3,11,5,1,1,3,2,0,1,1
11010,2011-01-22,"04,08,10,14,27","05,07",4,8,10,14,27,5,7,63,23,1,4,12,2,2,0,3,1,1,1,1
11011,2011-01-24,"02,17,23,24,30","02,09",2,17,23,24,30,2,9,96,28,2,3,11,7,1,1,1,3,1,1,1
11012,2011-01-26,"03,12,19,25,30","08,11",3,12,19,25,30,8,11,89,27,3,2,19,3,1,1,2,1,2,2,0
11013,2011-01-29,"05,08,14,28,30","04,06",5,8,14,28,30,4,6,85,25,1,4,10,2,0,2,2,1,2,0,2
11014,2011-01-31,"02,14,20,21,24","02,09",2,14,20,21,24,2,9,81,22,1,4,11,7,1,1,1,4,0,1,1
11015,2011-02-09,"08,18,19,22,23","01,03",8,18,19,22,23,1,3,90,15,2,3,4,2,2,0,1,4,0,0,2
11016,2011-02-12,"15,20,30,33,35","06,09",15,20,30,33,35,6,9,133,20,3,2,15,3,1,1,0,2,3,1,1
11017,2011-02-14,"16,19,24,26,31","02,04",16,19,24,26,31,2,4,116,15,2,3,6,2,0,2,0,3,2,0,2
11018,2011-02-16,"16,22,24,32,34","02,10",16,22,24,32,34,2,10,128,18,0,5,12,8,0,2,0,3,2,1,1
11019,2011-02-19,"08,21,23,27,33","06,11",8,21,23,27,33,6,11,112,25,4,1,17,5,1,1,1,2,2,1,1
11020,2011-02-21,"09,12,19,22,28","01,05",9,12,19,22,28,1,5,90,19,2,3,6,4,2,0,2,2,1,0,2
11021,2011-02-23,"01,09,13,17,30","02,08",1,9,13,17,30,2,8,70,29,4,1,10,6,0,2,2,2,1,1,1
11022,2011-02-26,"09,14,24,25,34","01,04",9,14,24,25,34,1,4,106,25,2,3,5,3,1,1,1,2,2,0,2
11023,2011-02-28,"05,13,16,18,24","02,12",5,13,16,18,24,2,12,76,19,2,3,14,10,0,2,1,4,0,1,1
11024,2011-03-02,"12,15,16,20,33","08,12",12,15,16,20,33,8,12,96,21,2,3,20,4,0,2,1,3,1,2,0
11025,2011-03-05,"08,09,25,28,29","02,10",8,9,25,28,29,2,10,99,21,3,2,12,8,0,2,2,0,3,1,1
11026,2011-03-07,"01,09,15,20,29","07,09",1,9,15,20,29,7,9,74,28,4,1,16,2,2,0,2,2,1,2,0
11027,2011-03-09,"05,14,25,34,35","02,05",5,14,25,34,35,2,5,113,30,3,2,7,3,1,1,1,1,3,0,2
11028,2011-03-12,"01,02,13,17,28","01,04",1,2,13,17,28,1,4,61,27,3,2,5,3,1,1,2,2,1,0,2
11029,2011-03-14,"03,09,17,24,28","06,12",3,9,17,24,28,6,12,81,25,3,2,18,6,0,2,2,2,1,1,1
11030,2011-03-16,"15,19,25,30,33","03,08",15,19,25,30,33,3,8,122,18,4,1,11,5,1,1,0,2,3,1,1
11031,2011-03-19,"12,17,19,22,35","04,11",12,17,19,22,35,4,11,105,23,3,2,15,7,1,1,1,3,1,1,1
11032,2011-03-21,"07,16,23,31,33","03,10",7,16,23,31,33,3,10,110,26,4,1,13,7,1,1,1,2,2,1,1
11033,2011-03-23,"03,19,24,29,33","03,09",3,19,24,29,33,3,9,108,30,4,1,12,6,2,0,1,2,2,1,1
11034,2011-03-26,"03,06,09,17,27","03,09",3,6,9,17,27,3,9,62,24,4,1,12,6,2,0,3,1,1,1,1
11035,2011-03-28,"03,04,13,15,32","04,09",3,4,13,15,32,4,9,67,29,3,2,13,5,1,1,2,2,1,1,1
11036,2011-03-30,"03,18,29,30,33","08,09",3,18,29,30,33,8,9,113,30,3,2,17,1,1,1,1,1,3,2,0
11037,2011-04-02,"01,12,14,22,24","10,12",1,12,14,22,24,10,12,73,23,1,4,22,2,0,2,2,3,0,2,0
11038,2011-04-04,"07,09,11,13,33","10,12",7,9,11,13,33,10,12,73,26,5,0,22,2,0,2,3,1,1,2,0
11039,2011-04-06,"01,11,14,22,34","06,08",1,11,14,22,34,6,8,82,33,2,3,14,2,0,2,2,2,1,1,1
11040,2011-04-09,"03,07,15,18,20","01,06",3,7,15,18,20,1,6,63,17,3,2,7,5,1,1,2,3,0,0,2
11041,2011-04-11,"04,05,11,13,25","03,06",4,5,11,13,25,3,6,58,21,4,1,9,3,1,1,3,1,1,0,2
11042,2011-04-13,"06,09,18,30,32","10,12",6,9,18,30,32,10,12,95,26,1,4,22,2,0,2,2,1,2,2,0
11043,2011-04-16,"02,08,23,33,35","05,10",2,8,23,33,35,5,10,101,33,3,2,15,5,1,1,2,1,2,1,1
11044,2011-04-18,"11,21,24,26,31","06,07",11,21,24,26,31,6,7,113,20,3,2,13,1,1,1,1,2,2,1,1
11045,2011-04-20,"13,21,22,29,31","07,11",13,21,22,29,31,7,11,116,18,4,1,18,4,2,0,0,3,2,2,0
11046,2011-04-23,"09,15,16,19,29","04,06",9,15,16,19,29,4,6,88,20,4,1,10,2,0,2,1,3,1,0,2
11047,2011-04-25,"02,15,22,33,35","05,08",2,15,22,33,35,5,8,107,33,3,2,13,3,1,1,1,2,2,1,1
11048,2011-04-27,"13,17,25,27,28","02,03",13,17,25,27,28,2,3,110,15,4,1,5,1,1,1,0,2,3,0,2
11049,2011-04-30,"05,06,10,22,25","01,09",5,6,10,22,25,1,9,68,20,2,3,10,8,2,0,3,1,1,1,1
11050,2011-05-02,"04,07,29,32,33","08,10",4,7,29,32,33,8,10,105,29,3,2,18,2,0,2,2,0,3,2,0
11051,2011-05-04,"06,08,12,17,18","05,10",6,8,12,17,18,5,10,61,12,1,4,15,5,1,1,3,2,0,1,1
11052,2011-05-07,"13,24,31,32,33","03,09",13,24,31,32,33,3,9,133,20,3,2,12,6,2,0,0,2,3,1,1
11053,2011-05-09,"03,16,28,31,32","01,09",3,16,28,31,32,1,9,110,29,2,3,10,8,2,0,1,1,3,1,1
11054,2011-05-11,"05,09,16,26,35","03,10",5,9,16,26,35,3,10,91,30,3,2,13,7,1,1,2,1,2,1,1
11055,2011-05-14,"01,07,31,32,35","02,10",1,7,31,32,35,2,10,106,34,4,1,12,8,0,2,2,0,3,1,1
11056,2011-05-16,"03,05,29,30,31","08,10",3,5,29,30,31,8,10,98,28,4,1,18,2,0,2,2,0,3,2,0
11057,2011-05-18,"07,11,30,31,34","09,12",7,11,30,31,34,9,12,113,27,3,2,21,3,1,1,2,0,3,2,0
11058,2011-05-21,"01,09,27,32,33","03,06",1,9,27,32,33,3,6,102,32,4,1,9,3,1,1,2,0,3,0,2
11059,2011-05-23,"09,16,21,29,34","07,10",9,16,21,29,34,7,10,109,25,3,2,17,3,1,1,1,2,2,2,0
11060,2011-05-25,"03,25,29,32,34","09,10",3,25,29,32,34,9,10,123,31,3,2,19,1,1,1,1,0,4,2,0
11061,2011-05-28,"06,07,16,18,20","04,10",6,7,16,18,20,4,10,67,14,1,4,14,6,0,2,2,3,0,1,1
11062,2011-05-30,"06,10,17,20,21","03,07",6,10,17,20,21,3,7,74,15,2,3,10,4,2,0,2,3,0,1,1
11063,2011-06-01,"10,17,18,26,32","01,05",10,17,18,26,32,1,5,103,22,1,4,6,4,2,0,1,2,2,0,2
11064,2011-06-04,"01,06,27,30,34","01,06",1,6,27,30,34,1,6,98,33,2,3,7,5,1,1,2,0,3,0,2
11065,2011-06-06,"03,11,14,25,34","01,04",3,11,14,25,34,1,4,87,31,3,2,5,3,1,1,2,1,2,0,2
11066,2011-06-08,"06,13,18,20,33","09,10",6,13,18,20,33,9,10,90,27,2,3,19,1,1,1,1,3,1,2,0
11067,2011-06-11,"10,17,22,24,32","03,10",10,17,22,24,32,3,10,105,22,1,4,13,7,1,1,1,3,1,1,1
11068,2011-06-13,"01,13,16,18,32","07,09",1,13,16,18,32,7,9,80,31,2,3,16,2,2,0,1,3,1,2,0
11069,2011-06-15,"03,05,28,29,33","04,12",3,5,28,29,33,4,12,98,30,4,1,16,8,0,2,2,0,3,1,1
11070,2011-06-18,"09,19,22,29,30","02,08",9,19,22,29,30,2,8,109,21,3,2,10,6,0,2,1,2,2,1,1
11071,2011-06-20,"27,31,33,34,35","04,06",27,31,33,34,35,4,6,160,8,4,1,10,2,0,2,0,0,5,0,2
11072,2011-06-22,"03,11,13,20,35","03,08",3,11,13,20,35,3,8,82,32,4,1,11,5,1,1,2,2,1,1,1
11073,2011-06-25,"13,19,20,22,33","05,11",13,19,20,22,33,5,11,107,20,3,2,16,6,2,0,0,4,1,1,1
11074,2011-06-27,"07,16,23,28,31","03,06",7,16,23,28,31,3,6,105,24,3,2,9,3,1,1,1,2,2,0,2
11075,2011-06-29,"06,09,20,23,28","06,10",6,9,20,23,28,6,10,86,22,2,3,16,4,0,2,2,2,1,1,1
11076,2011-07-02,"18,23,25,29,30","01,02",18,23,25,29,30,1,2,125,12,3,2,3,1,1,1,0,2,3,0,2
11077,2011-07-04,"05,08,19,33,34","01,12",5,8,19,33,34,1,12,99,29,3,2,13,11,1,1,2,1,2,1,1
11078,2011-07-06,"04,09,16,27,30","02,06",4,9,16,27,30,2,6,86,26,2,3,8,4,0,2,2,1,2,0,2
11079,2011-07-09,"01,03,23,30,31","02,10",1,3,23,30,31,2,10,88,30,4,1,12,8,0,2,2,1,2,1,1
11080,2011-07-11,"05,12,30,31,32","01,03",5,12,30,31,32,1,3,110,27,2,3,4,2,2,0,2,0,3,0,2
11081,2011-07-13,"04,13,20,21,35","02,09",4,13,20,21,35,2,9,93,31,3,2,11,7,1,1,1,3,1,1,1
11082,2011-07-16,"07,20,25,30,32","05,09",7,20,25,30,32,5,9,114,25,2,3,14,4,2,0,1,1,3,1,1
11083,2011-07-18,"06,08,18,20,24","04,08",6,8,18,20,24,4,8,76,18,0,5,12,4,0,2,2,3,0,1,1
11084,2011-07-20,"14,29,31,34,35","01,12",14,29,31,34,35,1,12,143,21,3,2,13,11,1,1,0,1,4,1,1
11085,2011-07-23,"02,17,19,21,22","03,10",2,17,19,21,22,3,10,81,20,3,2,13,7,1,1,1,4,0,1,1
11086,2011-07-25,"04,05,06,09,15","01,06",4,5,6,9,15,1,6,39,11,3,2,7,5,1,1,4,1,0,0,2
11087,2011-07-27,"06,13,20,25,34","07,09",6,13,20,25,34,7,9,98,28,2,3,16,2,2,0,1,2,2,2,0
11088,2011-07-30,"20,21,27,29,35","03,08",20,21,27,29,35,3,8,132,15,4,1,11,5,1,1,0,2,3,1,1
11089,2011-08-01,"05,06,23,27,34","03,04",5,6,23,27,34,3,4,95,29,3,2,7,1,1,1,2,1,2,0,2
11090,2011-08-03,"02,04,29,30,34","05,08",2,4,29,30,34,5,8,99,32,1,4,13,3,1,1,2,0,3,1,1
11091,2011-08-06,"11,17,23,29,30","06,08",11,17,23,29,30,6,8,110,19,4,1,14,2,0,2,1,2,2,1,1
11092,2011-08-08,"10,17,19,32,33","01,12",10,17,19,32,33,1,12,111,23,3,2,13,11,1,1,1,2,2,1,1
11093,2011-08-10,"04,06,08,19,31","10,11",4,6,8,19,31,10,11,68,27,2,3,21,1,1,1,3,1,1,2,0
11094,2011-08-13,"11,21,22,32,34","04,08",11,21,22,32,34,4,8,120,23,2,3,12,4,0,2,1,2,2,1,1
11095,2011-08-15,"09,12,17,19,29","06,11",9,12,17,19,29,6,11,86,20,4,1,17,5,1,1,2,2,1,1,1
11096,2011-08-17,"03,08,20,24,25","01,02",3,8,20,24,25,1,2,80,22,2,3,3,1,1,1,2,2,1,0,2
11097,2011-08-20,"04,19,28,31,33","11,12",4,19,28,31,33,11,12,115,29,3,2,23,1,1,1,1,1,3,2,0
11098,2011-08-22,"06,07,28,33,35","01,10",6,7,28,33,35,1,10,109,29,3,2,11,9,1,1,2,0,3,1,1
11099,2011-08-24,"02,06,09,12,20","05,08",2,6,9,12,20,5,8,49,18,1,4,13,3,1,1,4,1,0,1,1
11100,2011-08-27,"08,11,13,28,33","08,09",8,11,13,28,33,8,9,93,25,3,2,17,1,1,1,2,1,2,2,0
11101,2011-08-29,"05,12,20,28,30","03,07",5,12,20,28,30,3,7,95,25,1,4,10,4,2,0,2,1,2,1,1
11102,2011-08-31,"19,24,28,31,34","04,12",19,24,28,31,34,4,12,136,15,2,3,16,8,0,2,0,2,3,1,1
11103,2011-09-03,"03,04,26,29,34","01,03",3,4,26,29,34,1,3,96,31,2,3,4,2,2,0,2,0,3,0,2
11104,2011-09-05,"07,19,27,28,34","02,05",7,19,27,28,34,2,5,115,27,3,2,7,3,1,1,1,1,3,0,2
11105,2011-09-07,"02,11,26,32,33","05,12",2,11,26,32,33,5,12,104,31,2,3,17,7,1,1,2,0,3,1,1
11106,2011-09-10,"01,09,29,30,35","05,09",1,9,29,30,35,5,9,104,34,4,1,14,4,2,0,2,0,3,1,1
11107,2011-09-12,"02,06,18,30,32","01,08",2,6,18,30,32,1,8,88,30,0,5,9,7,1,1,2,1,2,1,1
11108,2011-09-14,"07,15,18,24,28","01,07",7,15,18,24,28,1,7,92,21,2,3,8,6,2,0,1,3,1,1,1
11109,2011-09-17,"01,11,12,22,34","08,10",1,11,12,22,34,8,10,80,33,2,3,18,2,0,2,3,1,1,2,0
11110,2011-09-19,"30,31,33,34,35","04,07",30,31,33,34,35,4,7,163,5,3,2,11,3,1,1,0,0,5,1,1
11111,2011-09-21,"02,11,13,23,31","11,12",2,11,13,23,31,11,12,80,29,4,1,23,1,1,1,2,2,1,2,0
11112,2011-09-24,"06,17,28,32,33","08,12",6,17,28,32,33,8,12,116,27,2,3,20,4,0,2,1,1,3,2,0
11113,2011-09-26,"04,05,07,10,12","04,05",4,5,7,10,12,4,5,38,8,2,3,9,1,1,1,5,0,0,0,2
11114,2011-09-28,"06,08,17,27,35","02,11",6,8,17,27,35,2,11,93,29,3,2,13,9,1,1,2,1,2,1,1
11115,2011-10-01,"17,26,30,31,35","06,11",17,26,30,31,35,6,11,139,18,3,2,17,5,1,1,0,1,4,1,1
11116,2011-10-03,"10,15,18,19,26","07,12",10,15,18,19,26,7,12,88,16,2,3,19,5,1,1,1,3,1,2,0
11117,2011-10-05,"10,12,28,32,33","03,05",10,12,28,32,33,3,5,115,23,1,4,8,2,2,0,2,0,3,0,2
11118,2011-10-08,"04,07,11,32,35","05,07",4,7,11,32,35,5,7,89,31,3,2,12,2,2,0,3,0,2,1,1
11119,2011-10-10,"04,15,20,26,31","06,12",4,15,20,26,31,6,12,96,27,2,3,18,6,0,2,1,2,2,1,1
11120,2011-10-12,"20,25,26,30,31","09,10",20,25,26,30,31,9,10,132,11,2,3,19,1,1,1,0,1,4,2,0
11121,2011-10-15,"02,03,30,31,33","03,09",2,3,30,31,33,3,9,99,31,3,2,12,6,2,0,2,0,3,1,1
11122,2011-10-17,"03,08,23,24,34","05,12",3,8,23,24,34,5,12,92,31,2,3,17,7,1,1,2,2,1,1,1
11123,2011-10-19,"10,14,18,19,35","01,06",10,14,18,19,35,1,6,96,25,2,3,7,5,1,1,1,3,1,0,2
11124,2011-10-22,"08,12,14,20,25","06,08",8,12,14,20,25,6,8,79,17,1,4,14,2,0,2,2,2,1,1,1
11125,2011-10-24,"07,10,27,34,35","10,12",7,10,27,34,35,10,12,113,28,3,2,22,2,0,2,2,0,3,2,0
11126,2011-10-26,"07,17,29,30,33","10,12",7,17,29,30,33,10,12,116,26,4,1,22,2,0,2,1,1,3,2,0
11127,2011-10-29,"01,11,22,26,29","05,08",1,11,22,26,29,5,8,89,28,3,2,13,3,1,1,2,1,2,1,1
11128,2011-10-31,"03,04,06,11,13","01,02",3,4,6,11,13,1,2,37,10,3,2,3,1,1,1,4,1,0,0,2
11129,2011-11-02,"01,07,13,18,23","04,08",1,7,13,18,23,4,8,62,22,4,1,12,4,0,2,2,3,0,1,1
11130,2011-11-05,"08,09,13,23,35","11,12",8,9,13,23,35,11,12,88,27,4,1,23,1,1,1,2,2,1,2,0
11131,2011-11-07,"03,05,12,18,33","07,11",3,5,12,18,33,7,11,71,30,3,2,18,4,2,0,3,1,1,2,0
11132,2011-11-09,"12,14,16,19,33","02,09",12,14,16,19,33,2,9,94,21,2,3,11,7,1,1,1,3,1,1,1
11133,2011-11-12,"04,11,23,26,35","03,12",4,11,23,26,35,3,12,99,31,3,2,15,9,1,1,2,1,2,1,1
11134,2011-11-14,"01,10,12,14,17","09,10",1,10,12,14,17,9,10,54,16,2,3,19,1,1,1,3,2,0,2,0
11135,2011-11-16,"06,22,29,33,35","03,12",6,22,29,33,35,3,12,125,29,3,2,15,9,1,1,1,1,3,1,1
11136,2011-11-19,"08,09,11,19,33","03,12",8,9,11,19,33,3,12,80,25,4,1,15,9,1,1,3,1,1,1,1
11137,2011-11-21,"02,15,18,23,31","01,02",2,15,18,23,31,1,2,89,29,3,2,3,1,1,1,1,3,1,0,2
11138,2011-11-23,"17,23,26,30,32","06,12",17,23,26,30,32,6,12,128,15,2,3,18,6,0,2,0,2,3,1,1
11139,2011-11-26,"04,06,10,15,16","03,04",4,6,10,15,16,3,4,51,12,1,4,7,1,1,1,3,2,0,0,2
11140,2011-11-28,"01,12,32,33,34","09,11",1,12,32,33,34,9,11,112,33,2,3,20,2,2,0,2,0,3,2,0
11141,2011-11-30,"02,11,19,22,35","10,12",2,11,19,22,35,10,12,89,33,3,2,22,2,0,2,2,2,1,2,0
11142,2011-12-03,"04,26,30,33,34","04,06",4,26,30,33,34,4,6,127,30,1,4,10,2,0,2,1,0,4,0,2
11143,2011-12-05,"08,09,12,25,33","07,10",8,9,12,25,33,7,10,87,25,3,2,17,3,1,1,3,0,2,2,0
11144,2011-12-07,"07,18,24,28,33","02,03",7,18,24,28,33,2,3,110,26,2,3,5,1,1,1,1,2,2,0,2
11145,2011-12-10,"07,15,19,24,29","04,06",7,15,19,24,29,4,6,94,22,4,1,10,2,0,2,1,3,1,0,2
11146,2011-12-12,"09,13,19,29,34","02,11",9,13,19,29,34,2,11,104,25,4,1,13,9,1,1,1,2,2,1,1
11147,2011-12-14,"01,15,16,27,28","02,07",1,15,16,27,28,2,7,87,27,3,2,9,5,1,1,1,2,2,1,1
11148,2011-12-17,"07,10,11,26,31","03,04",7,10,11,26,31,3,4,85,24,3,2,7,1,1,1,3,0,2,0,2
11149,2011-12-19,"02,07,12,29,31","03,05",2,7,12,29,31,3,5,81,29,3,2,8,2,2,0,3,0,2,0,2
11150,2011-12-21,"13,22,30,33,34","06,12",13,22,30,33,34,6,12,132,21,2,3,18,6,0,2,0,2,3,1,1
11151,2011-12-24,"07,11,14,20,27","03,10",7,11,14,20,27,3,10,79,20,3,2,13,7,1,1,2,2,1,1,1
11152,2011-12-26,"01,04,06,21,35","02,11",1,4,6,21,35,2,11,67,34,3,2,13,9,1,1,3,1,1,1,1
11153,2011-12-28,"06,22,29,30,35","03,05",6,22,29,30,35,3,5,122,29,2,3,8,2,2,0,1,1,3,0,2
11154,2011-12-31,"04,12,16,20,28","08,11",4,12,16,20,28,8,11,80,24,0,5,19,3,1,1,2,2,1,2,0
12001,2012-01-02,"07,27,28,32,33","01,12",7,27,28,32,33,1,12,127,26,3,2,13,11,1,1,1,0,4,1,1
12002,2012-01-04,"03,11,14,26,29","07,08",3,11,14,26,29,7,8,83,26,3,2,15,1,1,1,2,1,2,2,0
12003,2012-01-07,"16,22,24,33,34","03,10",16,22,24,33,34,3,10,129,18,1,4,13,7,1,1,0,3,2,1,1
12004,2012-01-09,"10,11,22,31,32","06,07",10,11,22,31,32,6,7,106,22,2,3,13,1,1,1,2,1,2,1,1
12005,2012-01-11,"01,02,29,31,33","07,12",1,2,29,31,33,7,12,96,32,4,1,19,5,1,1,2,0,3,2,0
12006,2012-01-14,"03,20,22,25,27","01,09",3,20,22,25,27,1,9,97,24,3,2,10,8,2,0,1,2,2,1,1
12007,2012-01-16,"04,05,13,17,25","07,10",4,5,13,17,25,7,10,64,21,4,1,17,3,1,1,2,2,1,2,0
12008,2012-01-18,"06,08,30,31,32","01,11",6,8,30,31,32,1,11,107,26,1,4,12,10,2,0,2,0,3,1,1
12009,2012-01-21,"06,14,20,29,35","09,10",6,14,20,29,35,9,10,104,29,2,3,19,1,1,1,1,2,2,2,0
12010,2012-01-30,"25,26,29,32,34","05,07",25,26,29,32,34,5,7,146,9,2,3,12,2,2,0,0,0,5,1,1
12011,2012-02-01,"05,19,22,29,30","02,04",5,19,22,29,30,2,4,105,25,3,2,6,2,0,2,1,2,2,0,2
12012,2012-02-04,"06,18,22,30,35","02,07",6,18,22,30,35,2,7,111,29,1,4,9,5,1,1,1,2,2,1,1
12013,2012-02-06,"07,08,11,12,24","01,02",7,8,11,12,24,1,2,62,17,2,3,3,1,1,1,4,1,0,0,2
12014,2012-02-08,"10,14,24,30,32","01,12",10,14,24,30,32,1,12,110,22,0,5,13,11,1,1,1,2,2,1,1
12015,2012-02-11,"12,13,24,26,33","06,08",12,13,24,26,33,6,8,108,21,2,3,14,2,0,2,1,2,2,1,1
12016,2012-02-13,"05,14,20,29,31","08,12",5,14,20,29,31,8,12,99,26,3,2,20,4,0,2,1,2,2,2,0
12017,2012-02-15,"06,11,22,29,34","03,12",6,11,22,29,34,3,12,102,28,2,3,15,9,1,1,2,1,2,1,1
12018,2012-02-18,"03,10,14,29,31","04,08",3,10,14,29,31,4,8,87,28,3,2,12,4,0,2,2,1,2,1,1
12019,2012-02-20,"07,09,17,30,34","01,12",7,9,17,30,34,1,12,97,27,3,2,13,11,1,1,2,1,2,1,1
12020,2012-02-22,"12,14,27,29,34","03,06",12,14,27,29,34,3,6,116,22,2,3,9,3,1,1,1,1,3,0,2
12021,2012-02-25,"10,15,21,31,34","07,08",10,15,21,31,34,7,8,111,24,3,2,15,1,1,1,1,2,2,2,0
12022,2012-02-27,"07,12,20,33,35","01,10",7,12,20,33,35,1,10,107,28,3,2,11,9,1,1,2,1,2,1,1
12023,2012-02-29,"07,09,17,29,35","09,10",7,9,17,29,35,9,10,97,28,5,0,19,1,1,1,2,1,2,2,0
12024,2012-03-03,"03,11,17,21,30","03,07",3,11,17,21,30,3,7,82,27,4,1,10,4,2,0,2,2,1,1,1
12025,2012-03-05,"01,02,05,12,27","04,07",1,2,5,12,27,4,7,47,26,3,2,11,3,1,1,4,0,1,1,1
12026,2012-03-07,"10,11,22,23,29","02,09",10,11,22,23,29,2,9,95,19,3,2,11,7,1,1,2,2,1,1,1
12027,2012-03-10,"03,10,11,22,31","05,07",3,10,11,22,31,5,7,77,28,3,2,12,2,2,0,3,1,1,1,1
12028,2012-03-12,"10,12,15,33,34","03,10",10,12,15,33,34,3,10,104,24,2,3,13,7,1,1,2,1,2,1,1
12029,2012-03-14,"04,07,08,18,29","07,10",4,7,8,18,29,7,10,66,25,2,3,17,3,1,1,3,1,1,2,0
12030,2012-03-17,"03,21,22,26,32","01,03",3,21,22,26,32,1,3,104,29,2,3,4,2,2,0,1,2,2,0,2
12031,2012-03-19,"19,21,23,25,30","03,08",19,21,23,25,30,3,8,118,11,4,1,11,5,1,1,0,3,2,1,1
12032,2012-03-21,"07,08,16,26,34","07,11",7,8,16,26,34,7,11,91,27,1,4,18,4,2,0,2,1,2,2,0
12033,2012-03-24,"08,13,19,27,32","01,08",8,13,19,27,32,1,8,99,24,3,2,9,7,1,1,1,2,2,1,1
12034,2012-03-26,"01,08,15,16,29","08,09",1,8,15,16,29,8,9,69,28,3,2,17,1,1,1,2,2,1,2,0
12035,2012-03-28,"01,04,30,32,35","08,12",1,4,30,32,35,8,12,102,34,2,3,20,4,0,2,2,0,3,2,0
12036,2012-03-31,"01,09,20,30,31","08,12",1,9,20,30,31,8,12,91,30,3,2,20,4,0,2,2,1,2,2,0
12037,2012-04-02,"09,13,27,31,35","03,10",9,13,27,31,35,3,10,115,26,5,0,13,7,1,1,1,1,3,1,1
12038,2012-04-04,"11,23,25,31,35","01,03",11,23,25,31,35,1,3,125,24,5,0,4,2,2,0,1,1,3,0,2
12039,2012-04-07,"15,21,22,24,35","01,05",15,21,22,24,35,1,5,117,20,3,2,6,4,2,0,0,4,1,0,2
12040,2012-04-09,"02,13,23,28,29","01,05",2,13,23,28,29,1,5,95,27,3,2,6,4,2,0,1,2,2,0,2
12041,2012-04-11,"01,02,13,22,23","02,10",1,2,13,22,23,2,10,61,22,3,2,12,8,0,2,2,3,0,1,1
12042,2012-04-14,"07,24,27,28,35","07,12",7,24,27,28,35,7,12,121,28,3,2,19,5,1,1,1,1,3,2,0
12043,2012-04-16,"01,06,25,31,34","03,09",1,6,25,31,34,3,9,97,33,3,2,12,6,2,0,2,0,3,1,1
12044,2012-04-18,"03,04,14,32,35","01,02",3,4,14,32,35,1,2,88,32,2,3,3,1,1,1,2,1,2,0,2
12045,2012-04-21,"05,11,17,20,28","11,12",5,11,17,20,28,11,12,81,23,3,2,23,1,1,1,2,2,1,2,0
12046,2012-04-23,"04,08,19,23,27","04,11",4,8,19,23,27,4,11,81,23,3,2,15,7,1,1,2,2,1,1,1
12047,2012-04-25,"05,07,17,30,34","03,10",5,7,17,30,34,3,10,93,29,3,2,13,7,1,1,2,1,2,1,1
12048,2012-04-28,"06,09,26,30,35","05,06",6,9,26,30,35,5,6,106,29,2,3,11,1,1,1,2,0,3,0,2
12049,2012-04-30,"09,18,22,27,31","10,12",9,18,22,27,31,10,12,107,22,3,2,22,2,0,2,1,2,2,2,0
12050,2012-05-02,"13,17,22,28,29","01,10",13,17,22,28,29,1,10,109,16,3,2,11,9,1,1,0,3,2,1,1
12051,2012-05-05,"01,02,17,18,33","05,12",1,2,17,18,33,5,12,71,32,3,2,17,7,1,1,2,2,1,1,1
12052,2012-05-07,"10,20,26,31,33","10,12",10,20,26,31,33,10,12,120,23,2,3,22,2,0,2,1,1,3,2,0
12053,2012-05-09,"11,12,26,28,31","07,12",11,12,26,28,31,7,12,108,20,2,3,19,5,1,1,2,0,3,2,0
12054,2012-05-12,"01,16,18,27,30","10,11",1,16,18,27,30,10,11,92,29,2,3,21,1,1,1,1,2,2,2,0
12055,2012-05-14,"07,22,26,32,33","01,08",7,22,26,32,33,1,8,120,26,2,3,9,7,1,1,1,1,3,1,1
12056,2012-05-16,"11,21,23,26,34","07,09",11,21,23,26,34,7,9,115,23,3,2,16,2,2,0,1,2,2,2,0
12057,2012-05-19,"01,02,14,33,34","03,05",1,2,14,33,34,3,5,84,33,2,3,8,2,2,0,2,1,2,0,2
12058,2012-05-21,"13,21,29,31,35","04,12",13,21,29,31,35,4,12,129,22,5,0,16,8,0,2,0,2,3,1,1
12059,2012-05-23,"09,13,19,21,27","03,04",9,13,19,21,27,3,4,89,18,5,0,7,1,1,1,1,3,1,0,2
12060,2012-05-26,"02,16,21,24,30","06,10",2,16,21,24,30,6,10,93,28,1,4,16,4,0,2,1,3,1,1,1
12061,2012-05-28,"05,10,14,27,33","07,09",5,10,14,27,33,7,9,89,28,3,2,16,2,2,0,2,1,2,2,0
12062,2012-05-30,"21,32,33,34,35","08,09",21,32,33,34,35,8,9,155,14,3,2,17,1,1,1,0,1,4,2,0
12063,2012-06-02,"11,25,26,29,35","01,02",11,25,26,29,35,1,2,126,24,4,1,3,1,1,1,1,0,4,0,2
12064,2012-06-04,"09,12,13,15,30","09,10",9,12,13,15,30,9,10,79,21,3,2,19,1,1,1,2,2,1,2,0
12065,2012-06-06,"10,22,28,29,34","05,11",10,22,28,29,34,5,11,123,24,1,4,16,6,2,0,1,1,3,1,1
12066,2012-06-09,"01,20,25,29,33","04,06",1,20,25,29,33,4,6,108,32,4,1,10,2,0,2,1,1,3,0,2
12067,2012-06-11,"20,22,27,30,33","01,02",20,22,27,30,33,1,2,132,13,2,3,3,1,1,1,0,2,3,0,2
12068,2012-06-13,"01,21,31,32,35","03,06",1,21,31,32,35,3,6,120,34,4,1,9,3,1,1,1,1,3,0,2
12069,2012-06-16,"02,04,22,25,34","02,11",2,4,22,25,34,2,11,87,32,1,4,13,9,1,1,2,1,2,1,1
12070,2012-06-18,"09,22,23,32,34","06,08",9,22,23,32,34,6,8,120,25,2,3,14,2,0,2,1,2,2,1,1
12071,2012-06-20,"13,23,29,31,34","06,08",13,23,29,31,34,6,8,130,21,4,1,14,2,0,2,0,2,3,1,1
12072,2012-06-23,"04,08,17,22,25","04,10",4,8,17,22,25,4,10,76,21,2,3,14,6,0,2,2,2,1,1,1
12073,2012-06-25,"18,23,29,33,34","02,07",18,23,29,33,34,2,7,137,16,3,2,9,5,1,1,0,2,3,1,1
12074,2012-06-27,"10,22,23,30,32","01,07",10,22,23,30,32,1,7,117,22,1,4,8,6,2,0,1,2,2,1,1
12075,2012-06-30,"07,09,10,18,22","05,10",7,9,10,18,22,5,10,66,15,2,3,15,5,1,1,3,2,0,1,1
12076,2012-07-02,"02,14,16,22,24","02,05",2,14,16,22,24,2,5,78,22,0,5,7,3,1,1,1,4,0,0,2
12077,2012-07-04,"10,30,32,33,34","02,03",10,30,32,33,34,2,3,139,24,1,4,5,1,1,1,1,0,4,0,2
12078,2012-07-07,"01,02,23,25,35","05,12",1,2,23,25,35,5,12,86,34,4,1,17,7,1,1,2,1,2,1,1
12079,2012-07-09,"01,05,25,32,33","01,10",1,5,25,32,33,1,10,96,32,4,1,11,9,1,1,2,0,3,1,1
12080,2012-07-11,"11,12,14,25,28","02,05",11,12,14,25,28,2,5,90,17,2,3,7,3,1,1,2,1,2,0,2
12081,2012-07-14,"10,16,17,30,35","01,08",10,16,17,30,35,1,8,108,25,2,3,9,7,1,1,1,2,2,1,1
12082,2012-07-16,"02,04,09,10,15","08,10",2,4,9,10,15,8,10,40,13,2,3,18,2,0,2,4,1,0,2,0
12083,2012-07-18,"16,19,28,29,31","05,08",16,19,28,29,31,5,8,123,15,3,2,13,3,1,1,0,2,3,1,1
12084,2012-07-21,"21,24,27,29,31","01,02",21,24,27,29,31,1,2,132,10,4,1,3,1,1,1,0,2,3,0,2
12085,2012-07-23,"07,18,29,31,33","10,12",7,18,29,31,33,10,12,118,26,4,1,22,2,0,2,1,1,3,2,0
12086,2012-07-25,"03,20,25,29,32","05,10",3,20,25,29,32,5,10,109,29,3,2,15,5,1,1,1,1,3,1,1
12087,2012-07-28,"01,06,07,21,31","04,11",1,6,7,21,31,4,11,66,30,4,1,15,7,1,1,3,1,1,1,1
12088,2012-07-30,"13,17,24,30,35","02,10",13,17,24,30,35,2,10,119,22,3,2,12,8,0,2,0,3,2,1,1
12089,2012-08-01,"06,12,21,29,32","06,11",6,12,21,29,32,6,11,100,26,2,3,17,5,1,1,2,1,2,1,1
12090,2012-08-04,"02,21,27,29,33","02,10",2,21,27,29,33,2,10,112,31,4,1,12,8,0,2,1,1,3,1,1
12091,2012-08-06,"03,10,28,31,33","01,09",3,10,28,31,33,1,9,105,30,3,2,10,8,2,0,2,0,3,1,1
12092,2012-08-08,"08,09,23,25,31","02,12",8,9,23,25,31,2,12,96,23,4,1,14,10,0,2,2,1,2,1,1
12093,2012-08-11,"02,16,21,31,33","04,11",2,16,21,31,33,4,11,103,31,3,2,15,7,1,1,1,2,2,1,1
12094,2012-08-13,"02,14,23,32,35","01,10",2,14,23,32,35,1,10,106,33,2,3,11,9,1,1,1,2,2,1,1
12095,2012-08-15,"06,09,22,27,30","08,12",6,9,22,27,30,8,12,94,24,2,3,20,4,0,2,2,1,2,2,0
12096,2012-08-18,"05,10,19,24,35","08,09",5,10,19,24,35,8,9,93,30,3,2,17,1,1,1,2,2,1,2,0
12097,2012-08-20,"09,17,24,29,32","01,02",9,17,24,29,32,1,2,111,23,3,2,3,1,1,1,1,2,2,0,2
12098,2012-08-22,"02,11,28,29,30","06,12",2,11,28,29,30,6,12,100,28,2,3,18,6,0,2,2,0,3,1,1
12099,2012-08-25,"12,18,24,25,32","02,12",12,18,24,25,32,2,12,111,20,1,4,14,10,0,2,1,2,2,1,1
12100,2012-08-27,"07,09,13,19,27","01,03",7,9,13,19,27,1,3,75,20,5,0,4,2,2,0,2,2,1,0,2
12101,2012-08-29,"02,05,08,09,31","03,07",2,5,8,9,31,3,7,55,29,3,2,10,4,2,0,4,0,1,1,1
12102,2012-09-01,"02,04,06,13,35","04,08",2,4,6,13,35,4,8,60,33,2,3,12,4,0,2,3,1,1,1,1
12103,2012-09-03,"02,09,18,23,24","01,04",2,9,18,23,24,1,4,76,22,2,3,5,3,1,1,2,3,0,0,2
12104,2012-09-05,"16,18,24,25,27","04,09",16,18,24,25,27,4,9,110,11,2,3,13,5,1,1,0,3,2,1,1
12105,2012-09-08,"05,06,14,15,31","06,08",5,6,14,15,31,6,8,71,26,3,2,14,2,0,2,2,2,1,1,1
12106,2012-09-10,"15,23,25,29,31","09,10",15,23,25,29,31,9,10,123,16,5,0,19,1,1,1,0,2,3,2,0
12107,2012-09-12,"04,07,09,22,33","01,03",4,7,9,22,33,1,3,75,29,3,2,4,2,2,0,3,1,1,0,2
12108,2012-09-15,"06,07,12,24,35","02,06",6,7,12,24,35,2,6,84,29,2,3,8,4,0,2,3,1,1,0,2
12109,2012-09-17,"01,22,30,32,35","09,11",1,22,30,32,35,9,11,120,34,2,3,20,2,2,0,1,1,3,2,0
12110,2012-09-19,"01,11,17,19,26","05,12",1,11,17,19,26,5,12,74,25,4,1,17,7,1,1,2,2,1,1,1
12111,2012-09-22,"01,24,25,30,33","04,11",1,24,25,30,33,4,11,113,32,3,2,15,7,1,1,1,1,3,1,1
12112,2012-09-24,"01,02,28,31,35","05,07",1,2,28,31,35,5,7,97,34,3,2,12,2,2,0,2,0,3,1,1
12113,2012-09-26,"03,10,22,27,29","03,12",3,10,22,27,29,3,12,91,26,3,2,15,9,1,1,2,1,2,1,1
12114,2012-09-29,"03,06,21,33,35","01,07",3,6,21,33,35,1,7,98,32,4,1,8,6,2,0,2,1,2,1,1
12115,2012-10-01,"01,06,13,19,23","06,09",1,6,13,19,23,6,9,62,22,4,1,15,3,1,1,2,3,0,1,1
12116,2012-10-03,"01,11,18,20,22","07,10",1,11,18,20,22,7,10,72,21,2,3,17,3,1,1,2,3,0,2,0
12117,2012-10-06,"01,12,18,21,33","07,08",1,12,18,21,33,7,8,85,32,3,2,15,1,1,1,2,2,1,2,0
12118,2012-10-08,"05,17,25,30,33","01,12",5,17,25,30,33,1,12,110,28,4,1,13,11,1,1,1,1,3,1,1
12119,2012-10-10,"05,06,09,19,32","06,09",5,6,9,19,32,6,9,71,27,3,2,15,3,1,1,3,1,1,1,1
12120,2012-10-13,"02,10,21,23,29","03,04",2,10,21,23,29,3,4,85,27,3,2,7,1,1,1,2,2,1,0,2
12121,2012-10-15,"07,18,20,29,30","05,06",7,18,20,29,30,5,6,104,23,2,3,11,1,1,1,1,2,2,0,2
12122,2012-10-17,"23,24,25,29,31","03,12",23,24,25,29,31,3,12,132,8,4,1,15,9,1,1,0,2,3,1,1
12123,2012-10-20,"05,08,18,30,33","01,09",5,8,18,30,33,1,9,94,28,2,3,10,8,2,0,2,1,2,1,1
12124,2012-10-22,"07,11,19,20,35","05,10",7,11,19,20,35,5,10,92,28,4,1,15,5,1,1,2,2,1,1,1
12125,2012-10-24,"06,14,17,22,35","01,02",6,14,17,22,35,1,2,94,29,2,3,3,1,1,1,1,3,1,0,2
12126,2012-10-27,"13,14,21,28,29","05,10",13,14,21,28,29,5,10,105,16,3,2,15,5,1,1,0,3,2,1,1
12127,2012-10-29,"12,13,14,25,35","10,12",12,13,14,25,35,10,12,99,23,3,2,22,2,0,2,1,2,2,2,0
12128,2012-10-31,"09,10,19,30,31","04,11",9,10,19,30,31,4,11,99,22,3,2,15,7,1,1,2,1,2,1,1
12129,2012-11-03,"01,07,21,28,31","03,09",1,7,21,28,31,3,9,88,30,4,1,12,6,2,0,2,1,2,1,1
12130,2012-11-05,"14,19,23,29,30","06,07",14,19,23,29,30,6,7,115,16,3,2,13,1,1,1,0,3,2,1,1
12131,2012-11-07,"02,16,18,27,30","08,12",2,16,18,27,30,8,12,93,28,1,4,20,4,0,2,1,2,2,2,0
12132,2012-11-10,"05,08,21,25,33","01,11",5,8,21,25,33,1,11,92,28,4,1,12,10,2,0,2,1,2,1,1
12133,2012-11-12,"05,07,13,29,30","01,05",5,7,13,29,30,1,5,84,25,4,1,6,4,2,0,2,1,2,0,2
12134,2012-11-14,"01,06,18,32,35","02,07",1,6,18,32,35,2,7,92,34,2,3,9,5,1,1,2,1,2,1,1
12135,2012-11-17,"03,05,17,18,33","06,07",3,5,17,18,33,6,7,76,30,4,1,13,1,1,1,2,2,1,1,1
12136,2012-11-19,"02,23,29,30,31","01,04",2,23,29,30,31,1,4,115,29,3,2,5,3,1,1,1,1,3,0,2
12137,2012-11-21,"03,12,20,21,27","01,06",3,12,20,21,27,1,6,83,24,3,2,7,5,1,1,2,2,1,0,2
12138,2012-11-24,"13,17,27,31,33","06,12",13,17,27,31,33,6,12,121,20,5,0,18,6,0,2,0,2,3,1,1
12139,2012-11-26,"09,10,12,22,25","04,11",9,10,12,22,25,4,11,78,16,2,3,15,7,1,1,3,1,1,1,1
12140,2012-11-28,"07,17,27,28,29","09,10",7,17,27,28,29,9,10,108,22,4,1,19,1,1,1,1,1,3,2,0
12141,2012-12-01,"03,11,19,23,34","02,12",3,11,19,23,34,2,12,90,31,4,1,14,10,0,2,2,2,1,1,1
12142,2012-12-03,"15,19,29,34,35","07,10",15,19,29,34,35,7,10,132,20,4,1,17,3,1,1,0,2,3,2,0
12143,2012-12-05,"09,27,29,30,31","03,06",9,27,29,30,31,3,6,126,22,4,1,9,3,1,1,1,0,4,0,2
12144,2012-12-08,"11,13,14,21,29","01,10",11,13,14,21,29,1,10,88,18,4,1,11,9,1,1,1,3,1,1,1
12145,2012-12-10,"05,22,31,33,35","06,09",5,22,31,33,35,6,9,126,30,4,1,15,3,1,1,1,1,3,1,1
12146,2012-12-12,"01,10,13,17,26","06,08",1,10,13,17,26,6,8,67,25,3,2,14,2,0,2,2,2,1,1,1
12147,2012-12-15,"02,03,17,19,33","02,09",2,3,17,19,33,2,9,74,31,4,1,11,7,1,1,2,2,1,1,1
12148,2012-12-17,"04,16,27,29,34","06,11",4,16,27,29,34,6,11,110,30,2,3,17,5,1,1,1,1,3,1,1
12149,2012-12-19,"02,10,23,33,34","05,10",2,10,23,33,34,5,10,102,32,2,3,15,5,1,1,2,1,2,1,1
12150,2012-12-22,"02,14,18,24,31","02,03",2,14,18,24,31,2,3,89,29,1,4,5,1,1,1,1,3,1,0,2
12151,2012-12-24,"03,19,20,24,33","03,04",3,19,20,24,33,3,4,99,30,3,2,7,1,1,1,1,3,1,0,2
12152,2012-12-26,"04,17,26,33,34","02,08",4,17,26,33,34,2,8,114,30,2,3,10,6,0,2,1,1,3,1,1
12153,2012-12-29,"08,09,10,13,22","05,10",8,9,10,13,22,5,10,62,14,2,3,15,5,1,1,3,2,0,1,1
12154,2012-12-31,"03,26,27,31,32","03,09",3,26,27,31,32,3,9,119,29,3,2,12,6,2,0,1,0,4,1,1
13001,2013-01-02,"06,09,11,31,32","05,11",6,9,11,31,32,5,11,89,26,3,2,16,6,2,0,3,0,2,1,1
13002,2013-01-05,"04,20,27,31,32","06,12",4,20,27,31,32,6,12,114,28,2,3,18,6,0,2,1,1,3,1,1
13003,2013-01-07,"01,16,18,21,31","09,12",1,16,18,21,31,9,12,87,30,3,2,21,3,1,1,1,3,1,2,0
13004,2013-01-09,"07,08,12,20,25","03,07",7,8,12,20,25,3,7,72,18,2,3,10,4,2,0,3,1,1,1,1
13005,2013-01-12,"18,22,26,28,31","10,12",18,22,26,28,31,10,12,125,13,1,4,22,2,0,2,0,2,3,2,0
13006,2013-01-14,"08,20,25,31,32","05,07",8,20,25,31,32,5,7,116,24,2,3,12,2,2,0,1,1,3,1,1
13007,2013-01-16,"14,29,32,33,34","03,06",14,29,32,33,34,3,6,142,20,2,3,9,3,1,1,0,1,4,0,2
13008,2013-01-19,"02,07,25,29,34","03,06",2,7,25,29,34,3,6,97,32,3,2,9,3,1,1,2,0,3,0,2
13009,2013-01-21,"10,17,19,27,29","05,12",10,17,19,27,29,5,12,102,19,4,1,17,7,1,1,1,2,2,1,1
13010,2013-01-23,"09,15,17,18,29","09,11",9,15,17,18,29,9,11,88,20,4,1,20,2,2,0,1,3,1,2,0
13011,2013-01-26,"01,02,08,15,23","06,09",1,2,8,15,23,6,9,49,22,3,2,15,3,1,1,3,2,0,1,1
13012,2013-01-28,"01,14,31,32,34","02,11",1,14,31,32,34,2,11,112,33,2,3,13,9,1,1,1,1,3,1,1
13013,2013-01-30,"13,15,29,30,35","01,11",13,15,29,30,35,1,11,122,22,4,1,12,10,2,0,0,2,3,1,1
13014,2013-02-02,"05,08,25,29,31","02,04",5,8,25,29,31,2,4,98,26,4,1,6,2,0,2,2,0,3,0,2
13015,2013-02-04,"14,15,26,32,33","01,11",14,15,26,32,33,1,11,120,19,2,3,12,10,2,0,0,2,3,1,1
13016,2013-02-06,"05,15,19,27,32","08,09",5,15,19,27,32,8,9,98,27,4,1,17,1,1,1,1,2,2,2,0
13017,2013-02-16,"11,14,22,29,34","05,11",11,14,22,29,34,5,11,110,23,2,3,16,6,2,0,1,2,2,1,1
13018,2013-02-18,"20,23,31,33,34","03,09",20,23,31,33,34,3,9,141,14,3,2,12,6,2,0,0,2,3,1,1
13019,2013-02-20,"06,12,17,29,30","07,11",6,12,17,29,30,7,11,94,24,2,3,18,4,2,0,2,1,2,2,0
13020,2013-02-23,"06,11,20,31,32","05,09",6,11,20,31,32,5,9,100,26,2,3,14,4,2,0,2,1,2,1,1
13021,2013-02-25,"23,24,28,30,33","01,11",23,24,28,30,33,1,11,138,10,2,3,12,10,2,0,0,2,3,1,1
13022,2013-02-27,"03,04,13,17,23","03,08",3,4,13,17,23,3,8,60,20,4,1,11,5,1,1,2,3,0,1,1
13023,2013-03-02,"05,19,24,26,35","05,07",5,19,24,26,35,5,7,109,30,3,2,12,2,2,0,1,2,2,1,1
13024,2013-03-04,"09,12,14,18,24","01,04",9,12,14,18,24,1,4,77,15,1,4,5,3,1,1,2,3,0,0,2
13025,2013-03-06,"03,23,25,26,28","10,12",3,23,25,26,28,10,12,105,25,3,2,22,2,0,2,1,1,3,2,0
13026,2013-03-09,"02,10,16,30,33","05,06",2,10,16,30,33,5,6,91,31,1,4,11,1,1,1,2,1,2,0,2
13027,2013-03-11,"03,12,14,24,35","03,08",3,12,14,24,35,3,8,88,32,2,3,11,5,1,1,2,2,1,1,1
13028,2013-03-13,"13,19,28,30,34","08,12",13,19,28,30,34,8,12,124,21,2,3,20,4,0,2,0,2,3,2,0
13029,2013-03-16,"05,07,17,25,26","04,10",5,7,17,25,26,4,10,80,21,4,1,14,6,0,2,2,1,2,1,1
13030,2013-03-18,"03,05,09,10,28","05,07",3,5,9,10,28,5,7,55,25,3,2,12,2,2,0,4,0,1,1,1
13031,2013-03-20,"12,17,18,26,32","10,11",12,17,18,26,32,10,11,105,20,1,4,21,1,1,1,1,2,2,2,0
13032,2013-03-23,"12,27,28,33,35","01,08",12,27,28,33,35,1,8,135,23,3,2,9,7,1,1,1,0,4,1,1
13033,2013-03-25,"12,18,22,28,31","01,11",12,18,22,28,31,1,11,111,19,1,4,12,10,2,0,1,2,2,1,1
13034,2013-03-27,"01,03,11,19,29","04,08",1,3,11,19,29,4,8,63,28,5,0,12,4,0,2,3,1,1,1,1
13035,2013-03-30,"05,14,28,32,34","07,08",5,14,28,32,34,7,8,113,29,1,4,15,1,1,1,1,1,3,2,0
13036,2013-04-01,"08,12,32,33,35","03,05",8,12,32,33,35,3,5,120,27,2,3,8,2,2,0,2,0,3,0,2
13037,2013-04-03,"02,26,31,32,34","06,08",2,26,31,32,34,6,8,125,32,1,4,14,2,0,2,1,0,4,1,1
13038,2013-04-06,"01,19,24,25,26","07,09",1,19,24,25,26,7,9,95,25,3,2,16,2,2,0,1,2,2,2,0
13039,2013-04-08,"06,23,30,33,35","07,10",6,23,30,33,35,7,10,127,29,3,2,17,3,1,1,1,1,3,2,0
13040,2013-04-10,"16,17,22,26,35","03,10",16,17,22,26,35,3,10,116,19,2,3,13,7,1,1,0,3,2,1,1
13041,2013-04-13,"03,13,14,15,34","05,08",3,13,14,15,34,5,8,79,31,3,2,13,3,1,1,1,3,1,1,1
13042,2013-04-15,"02,06,22,23,33","01,06",2,6,22,23,33,1,6,86,31,2,3,7,5,1,1,2,2,1,0,2
13043,2013-04-17,"07,13,25,34,35","07,09",7,13,25,34,35,7,9,114,28,4,1,16,2,2,0,1,1,3,2,0
13044,2013-04-20,"07,11,13,18,28","05,10",7,11,13,18,28,5,10,77,21,3,2,15,5,1,1,2,2,1,1,1
13045,2013-04-22,"08,11,12,21,25","02,07",8,11,12,21,25,2,7,77,17,3,2,9,5,1,1,3,1,1,1,1
13046,2013-04-24,"15,16,19,25,32","05,11",15,16,19,25,32,5,11,107,17,3,2,16,6,2,0,0,3,2,1,1
13047,2013-04-27,"12,20,28,30,35","03,11",12,20,28,30,35,3,11,125,23,1,4,14,8,2,0,1,1,3,1,1
13048,2013-04-29,"10,11,23,32,33","01,04",10,11,23,32,33,1,4,109,23,3,2,5,3,1,1,2,1,2,0,2
13049,2013-05-01,"18,22,25,31,32","04,06",18,22,25,31,32,4,6,128,14,2,3,10,2,0,2,0,2,3,0,2
13050,2013-05-04,"14,22,30,32,33","07,08",14,22,30,32,33,7,8,131,19,1,4,15,1,1,1,0,2,3,2,0
13051,2013-05-06,"05,08,15,18,33","07,08",5,8,15,18,33,7,8,79,28,3,2,15,1,1,1,2,2,1,2,0
13052,2013-05-08,"01,02,10,29,31","01,10",1,2,10,29,31,1,10,73,30,3,2,11,9,1,1,3,0,2,1,1
13053,2013-05-11,"13,31,33,34,35","05,07",13,31,33,34,35,5,7,146,22,4,1,12,2,2,0,0,1,4,1,1
13054,2013-05-13,"05,08,21,30,32","01,08",5,8,21,30,32,1,8,96,27,2,3,9,7,1,1,2,1,2,1,1
13055,2013-05-15,"04,05,22,23,24","03,09",4,5,22,23,24,3,9,78,20,2,3,12,6,2,0,2,3,0,1,1
13056,2013-05-18,"11,22,30,32,35","03,04",11,22,30,32,35,3,4,130,24,2,3,7,1,1,1,1,1,3,0,2
13057,2013-05-20,"07,15,27,33,35","07,10",7,15,27,33,35,7,10,117,28,5,0,17,3,1,1,1,1,3,2,0
13058,2013-05-22,"20,21,27,31,35","07,11",20,21,27,31,35,7,11,134,15,4,1,18,4,2,0,0,2,3,2,0
13059,2013-05-25,"03,08,11,24,27","07,12",3,8,11,24,27,7,12,73,24,3,2,19,5,1,1,3,1,1,2,0
13060,2013-05-27,"15,25,26,32,35","05,10",15,25,26,32,35,5,10,133,20,3,2,15,5,1,1,0,1,4,1,1
13061,2013-05-29,"01,14,18,21,32","05,10",1,14,18,21,32,5,10,86,31,2,3,15,5,1,1,1,3,1,1,1
13062,2013-06-01,"01,05,08,09,12","09,12",1,5,8,9,12,9,12,35,11,3,2,21,3,1,1,5,0,0,2,0
13063,2013-06-03,"03,05,11,27,28","05,06",3,5,11,27,28,5,6,74,25,4,1,11,1,1,1,3,0,2,0,2
13064,2013-06-05,"21,24,26,28,32","01,03",21,24,26,28,32,1,3,131,11,1,4,4,2,2,0,0,2,3,0,2
13065,2013-06-08,"09,28,31,34,35","02,09",9,28,31,34,35,2,9,137,26,3,2,11,7,1,1,1,0,4,1,1
13066,2013-06-10,"06,07,13,33,34","02,11",6,7,13,33,34,2,11,93,28,3,2,13,9,1,1,2,1,2,1,1
13067,2013-06-12,"02,03,05,08,29","10,12",2,3,5,8,29,10,12,47,27,3,2,22,2,0,2,4,0,1,2,0
13068,2013-06-15,"10,17,27,34,35","05,07",10,17,27,34,35,5,7,123,25,3,2,12,2,2,0,1,1,3,1,1
13069,2013-06-17,"06,12,13,16,30","07,12",6,12,13,16,30,7,12,77,24,1,4,19,5,1,1,2,2,1,2,0
13070,2013-06-19,"09,12,18,21,29","01,08",9,12,18,21,29,1,8,89,20,3,2,9,7,1,1,2,2,1,1,1
13071,2013-06-22,"13,19,26,27,28","03,11",13,19,26,27,28,3,11,113,15,3,2,14,8,2,0,0,2,3,1,1
13072,2013-06-24,"12,27,28,33,35","03,05",12,27,28,33,35,3,5,135,23,3,2,8,2,2,0,1,0,4,0,2
13073,2013-06-26,"03,05,23,27,31","02,06",3,5,23,27,31,2,6,89,28,5,0,8,4,0,2,2,1,2,0,2
13074,2013-06-29,"06,14,20,24,32","01,07",6,14,20,24,32,1,7,96,26,0,5,8,6,2,0,1,3,1,1,1
13075,2013-07-01,"01,11,13,19,35","07,08",1,11,13,19,35,7,8,79,34,5,0,15,1,1,1,2,2,1,2,0
13076,2013-07-03,"13,15,16,26,27","09,10",13,15,16,26,27,9,10,97,14,3,2,19,1,1,1,0,3,2,2,0
13077,2013-07-06,"24,26,30,32,35","06,12",24,26,30,32,35,6,12,147,11,1,4,18,6,0,2,0,1,4,1,1
13078,2013-07-08,"02,07,23,31,33","02,08",2,7,23,31,33,2,8,96,31,4,1,10,6,0,2,2,1,2,1,1
13079,2013-07-10,"09,10,17,21,34","01,07",9,10,17,21,34,1,7,91,25,3,2,8,6,2,0,2,2,1,1,1
13080,2013-07-13,"06,21,23,27,31","04,06",6,21,23,27,31,4,6,108,25,4,1,10,2,0,2,1,2,2,0,2
13081,2013-07-15,"07,09,15,17,23","02,07",7,9,15,17,23,2,7,71,16,5,0,9,5,1,1,2,3,0,1,1
13082,2013-07-17,"03,09,25,26,33","03,12",3,9,25,26,33,3,12,96,30,4,1,15,9,1,1,2,0,3,1,1
13083,2013-07-20,"26,29,30,32,35","04,10",26,29,30,32,35,4,10,152,9,2,3,14,6,0,2,0,0,5,1,1
13084,2013-07-22,"08,22,26,29,35","01,05",8,22,26,29,35,1,5,120,27,2,3,6,4,2,0,1,1,3,0,2
13085,2013-07-24,"08,19,23,27,32","03,05",8,19,23,27,32,3,5,109,24,3,2,8,2,2,0,1,2,2,0,2
13086,2013-07-27,"09,16,26,29,31","06,09",9,16,26,29,31,6,9,111,22,3,2,15,3,1,1,1,1,3,1,1
13087,2013-07-29,"09,12,22,32,34","02,04",9,12,22,32,34,2,4,109,25,1,4,6,2,0,2,2,1,2,0,2
13088,2013-07-31,"03,05,08,33,35","01,03",3,5,8,33,35,1,3,84,32,4,1,4,2,2,0,3,0,2,0,2
13089,2013-08-03,"06,07,23,24,29","04,11",6,7,23,24,29,4,11,89,23,3,2,15,7,1,1,2,2,1,1,1
13090,2013-08-05,"02,26,30,31,33","11,12",2,26,30,31,33,11,12,122,31,2,3,23,1,1,1,1,0,4,2,0
13091,2013-08-07,"04,09,28,34,35","02,08",4,9,28,34,35,2,8,110,31,2,3,10,6,0,2,2,0,3,1,1
13092,2013-08-10,"07,10,21,27,33","03,09",7,10,21,27,33,3,9,98,26,4,1,12,6,2,0,2,1,2,1,1
13093,2013-08-12,"01,05,17,18,26","05,07",1,5,17,18,26,5,7,67,25,3,2,12,2,2,0,2,2,1,1,1
13094,2013-08-14,"03,28,33,34,35","06,09",3,28,33,34,35,6,9,133,32,3,2,15,3,1,1,1,0,4,1,1
13095,2013-08-17,"03,17,28,30,33","01,10",3,17,28,30,33,1,10,111,30,3,2,11,9,1,1,1,1,3,1,1
13096,2013-08-19,"17,19,20,22,26","06,08",17,19,20,22,26,6,8,104,9,2,3,14,2,0,2,0,4,1,1,1
13097,2013-08-21,"07,08,13,17,32","03,08",7,8,13,17,32,3,8,77,25,3,2,11,5,1,1,2,2,1,1,1
13098,2013-08-24,"02,06,16,29,34","10,11",2,6,16,29,34,10,11,87,32,1,4,21,1,1,1,2,1,2,2,0
13099,2013-08-26,"04,11,28,30,33","05,12",4,11,28,30,33,5,12,106,29,2,3,17,7,1,1,2,0,3,1,1
13100,2013-08-28,"09,12,24,26,30","05,09",9,12,24,26,30,5,9,101,21,1,4,14,4,2,0,2,1,2,1,1
13101,2013-08-31,"04,09,13,15,32","02,09",4,9,13,15,32,2,9,73,28,3,2,11,7,1,1,2,2,1,1,1
13102,2013-09-02,"06,12,15,19,26","02,11",6,12,15,19,26,2,11,78,20,2,3,13,9,1,1,2,2,1,1,1
13103,2013-09-04,"05,08,13,16,31","03,09",5,8,13,16,31,3,9,73,26,3,2,12,6,2,0,2,2,1,1,1
13104,2013-09-07,"02,05,11,27,29","01,11",2,5,11,27,29,1,11,74,27,4,1,12,10,2,0,3,0,2,1,1
13105,2013-09-09,"07,13,27,30,34","01,12",7,13,27,30,34,1,12,111,27,3,2,13,11,1,1,1,1,3,1,1
13106,2013-09-11,"06,07,12,13,27","03,12",6,7,12,13,27,3,12,65,21,3,2,15,9,1,1,3,1,1,1,1
13107,2013-09-14,"07,13,14,18,25","05,12",7,13,14,18,25,5,12,77,18,3,2,17,7,1,1,1,3,1,1,1
13108,2013-09-16,"05,10,13,15,18","02,11",5,10,13,15,18,2,11,61,13,3,2,13,9,1,1,2,3,0,1,1
13109,2013-09-18,"13,20,26,29,32","02,06",13,20,26,29,32,2,6,120,19,2,3,8,4,0,2,0,2,3,0,2
13110,2013-09-21,"07,16,18,32,33","02,07",7,16,18,32,33,2,7,106,26,2,3,9,5,1,1,1,2,2,1,1
13111,2013-09-23,"07,12,13,20,27","01,03",7,12,13,20,27,1,3,79,20,3,2,4,2,2,0,2,2,1,0,2
13112,2013-09-25,"02,10,20,22,29","05,12",2,10,20,22,29,5,12,83,27,1,4,17,7,1,1,2,2,1,1,1
13113,2013-09-28,"19,21,23,28,30","08,12",19,21,23,28,30,8,12,121,11,3,2,20,4,0,2,0,3,2,2,0
13114,2013-09-30,"06,17,21,23,33","01,09",6,17,21,23,33,1,9,100,27,4,1,10,8,2,0,1,3,1,1,1
13115,2013-10-02,"05,16,29,32,34","04,11",5,16,29,32,34,4,11,116,29,2,3,15,7,1,1,1,1,3,1,1
13116,2013-10-05,"13,22,23,30,33","09,11",13,22,23,30,33,9,11,121,20,3,2,20,2,2,0,0,3,2,2,0
13117,2013-10-07,"05,16,23,25,33","07,12",5,16,23,25,33,7,12,102,28,4,1,19,5,1,1,1,2,2,2,0
13118,2013-10-09,"04,06,11,20,31","01,05",4,6,11,20,31,1,5,72,27,2,3,6,4,2,0,3,1,1,0,2
13119,2013-10-12,"01,02,16,23,35","01,11",1,2,16,23,35,1,11,77,34,3,2,12,10,2,0,2,2,1,1,1
13120,2013-10-14,"06,14,15,22,26","03,11",6,14,15,22,26,3,11,83,20,1,4,14,8,2,0,1,3,1,1,1
13121,2013-10-16,"03,18,19,20,24","03,12",3,18,19,20,24,3,12,84,21,2,3,15,9,1,1,1,4,0,1,1
13122,2013-10-19,"15,17,20,24,35","04,12",15,17,20,24,35,4,12,111,20,3,2,16,8,0,2,0,4,1,1,1
13123,2013-10-21,"02,09,10,33,34","05,12",2,9,10,33,34,5,12,88,32,2,3,17,7,1,1,3,0,2,1,1
13124,2013-10-23,"05,07,18,21,32","10,11",5,7,18,21,32,10,11,83,27,3,2,21,1,1,1,2,2,1,2,0
13125,2013-10-26,"04,08,14,23,28","04,08",4,8,14,23,28,4,8,77,24,1,4,12,4,0,2,2,2,1,1,1
13126,2013-10-28,"09,10,15,18,30","03,06",9,10,15,18,30,3,6,82,21,2,3,9,3,1,1,2,2,1,0,2
13127,2013-10-30,"03,14,16,19,32","05,10",3,14,16,19,32,5,10,84,29,2,3,15,5,1,1,1,3,1,1,1
13128,2013-11-02,"11,13,27,33,35","01,02",11,13,27,33,35,1,2,119,24,5,0,3,1,1,1,1,1,3,0,2
13129,2013-11-04,"11,23,29,30,33","01,04",11,23,29,30,33,1,4,126,22,4,1,5,3,1,1,1,1,3,0,2
13130,2013-11-06,"08,09,15,19,30","06,09",8,9,15,19,30,6,9,81,22,3,2,15,3,1,1,2,2,1,1,1
13131,2013-11-09,"12,15,29,30,31","04,12",12,15,29,30,31,4,12,117,19,3,2,16,8,0,2,1,1,3,1,1
13132,2013-11-11,"23,26,28,31,34","02,10",23,26,28,31,34,2,10,142,11,2,3,12,8,0,2,0,1,4,1,1
13133,2013-11-13,"02,08,10,16,17","09,12",2,8,10,16,17,9,12,53,15,1,4,21,3,1,1,3,2,0,2,0
13134,2013-11-16,"02,13,19,23,32","02,09",2,13,19,23,32,2,9,89,30,3,2,11,7,1,1,1,3,1,1,1
13135,2013-11-18,"04,13,19,25,26","07,12",4,13,19,25,26,7,12,87,22,3,2,19,5,1,1,1,2,2,2,0
13136,2013-11-20,"05,11,15,25,28","05,11",5,11,15,25,28,5,11,84,23,4,1,16,6,2,0,2,1,2,1,1
13137,2013-11-23,"04,12,32,33,34","06,08",4,12,32,33,34,6,8,115,30,1,4,14,2,0,2,2,0,3,1,1
13138,2013-11-25,"03,08,13,17,24","07,09",3,8,13,17,24,7,9,65,21,3,2,16,2,2,0,2,3,0,2,0
13139,2013-11-27,"05,06,18,20,31","06,07",5,6,18,20,31,6,7,80,26,2,3,13,1,1,1,2,2,1,1,1
13140,2013-11-30,"01,12,17,26,28","01,06",1,12,17,26,28,1,6,84,27,2,3,7,5,1,1,2,1,2,0,2
13141,2013-12-02,"05,15,18,25,31","08,10",5,15,18,25,31,8,10,94,26,4,1,18,2,0,2,1,2,2,2,0
13142,2013-12-04,"06,11,25,28,29","04,12",6,11,25,28,29,4,12,99,23,3,2,16,8,0,2,2,0,3,1,1
13143,2013-12-07,"03,08,14,21,31","06,08",3,8,14,21,31,6,8,77,28,3,2,14,2,0,2,2,2,1,1,1
13144,2013-12-09,"03,20,21,23,35","02,08",3,20,21,23,35,2,8,102,32,4,1,10,6,0,2,1,3,1,1,1
13145,2013-12-11,"02,13,15,18,20","02,11",2,13,15,18,20,2,11,68,18,2,3,13,9,1,1,1,4,0,1,1
13146,2013-12-14,"06,07,15,25,31","01,09",6,7,15,25,31,1,9,84,25,4,1,10,8,2,0,2,1,2,1,1
13147,2013-12-16,"03,09,22,24,25","05,09",3,9,22,24,25,5,9,83,22,3,2,14,4,2,0,2,2,1,1,1
13148,2013-12-18,"02,05,09,29,32","03,07",2,5,9,29,32,3,7,77,30,3,2,10,4,2,0,3,0,2,1,1
13149,2013-12-21,"06,07,08,09,13","05,07",6,7,8,9,13,5,7,43,7,3,2,12,2,2,0,4,1,0,1,1
13150,2013-12-23,"06,07,14,18,22","08,11",6,7,14,18,22,8,11,67,16,1,4,19,3,1,1,2,3,0,2,0
13151,2013-12-25,"02,13,21,27,30","03,04",2,13,21,27,30,3,4,93,28,3,2,7,1,1,1,1,2,2,0,2
13152,2013-12-28,"09,12,14,18,19","03,09",9,12,14,18,19,3,9,72,10,2,3,12,6,2,0,2,3,0,1,1
13153,2013-12-30,"04,05,16,17,30","03,09",4,5,16,17,30,3,9,72,26,2,3,12,6,2,0,2,2,1,1,1
14001,2014-01-01,"05,13,20,23,29","08,11",5,13,20,23,29,8,11,90,24,4,1,19,3,1,1,1,3,1,2,0
14002,2014-01-04,"01,12,21,24,29","01,07",1,12,21,24,29,1,7,87,28,3,2,8,6,2,0,2,2,1,1,1
14003,2014-01-06,"07,11,13,21,33","05,06",7,11,13,21,33,5,6,85,26,5,0,11,1,1,1,2,2,1,0,2
14004,2014-01-08,"07,10,19,27,28","09,12",7,10,19,27,28,9,12,91,21,3,2,21,3,1,1,2,1,2,2,0
14005,2014-01-11,"15,17,18,29,33","04,08",15,17,18,29,33,4,8,112,18,4,1,12,4,0,2,0,3,2,1,1
14006,2014-01-13,"01,04,07,16,35","06,08",1,4,7,16,35,6,8,63,34,3,2,14,2,0,2,3,1,1,1,1
14007,2014-01-15,"08,11,14,21,32","03,11",8,11,14,21,32,3,11,86,24,2,3,14,8,2,0,2,2,1,1,1
14008,2014-01-18,"11,13,20,28,35","01,05",11,13,20,28,35,1,5,107,24,3,2,6,4,2,0,1,2,2,0,2
14009,2014-01-20,"10,18,25,29,33","07,08",10,18,25,29,33,7,8,115,23,3,2,15,1,1,1,1,1,3,2,0
14010,2014-01-22,"05,10,20,26,27","01,03",5,10,20,26,27,1,3,88,22,2,3,4,2,2,0,2,1,2,0,2
14011,2014-01-25,"04,06,14,24,35","07,12",4,6,14,24,35,7,12,83,31,1,4,19,5,1,1,2,2,1,2,0
14012,2014-01-27,"09,20,21,23,29","05,07",9,20,21,23,29,5,7,102,20,4,1,12,2,2,0,1,3,1,1,1
14013,2014-01-29,"10,11,13,22,28","04,12",10,11,13,22,28,4,12,84,18,2,3,16,8,0,2,2,2,1,1,1
14014,2014-02-08,"01,09,11,27,29","03,11",1,9,11,27,29,3,11,77,28,5,0,14,8,2,0,3,0,2,1,1
14015,2014-02-10,"04,06,18,20,30","05,07",4,6,18,20,30,5,7,78,26,0,5,12,2,2,0,2,2,1,1,1
14016,2014-02-12,"04,06,13,24,34","04,09",4,6,13,24,34,4,9,81,30,1,4,13,5,1,1,2,2,1,1,1
14017,2014-02-15,"05,10,11,23,34","01,10",5,10,11,23,34,1,10,83,29,3,2,11,9,1,1,3,1,1,1,1
14018,2014-02-17,"08,09,12,28,34","02,12",8,9,12,28,34,2,12,91,26,1,4,14,10,0,2,3,0,2,1,1
14019,2014-02-19,"07,12,22,29,32","11,12",7,12,22,29,32,11,12,102,25,2,3,23,1,1,1,2,1,2,2,0
14020,2014-02-22,"01,14,17,30,35","06,07",1,14,17,30,35,6,7,97,34,3,2,13,1,1,1,1,2,2,1,1
14021,2014-02-24,"06,10,17,23,24","03,09",6,10,17,23,24,3,9,80,18,2,3,12,6,2,0,2,3,0,1,1
14022,2014-02-26,"03,06,10,16,25","10,11",3,6,10,16,25,10,11,60,22,2,3,21,1,1,1,3,1,1,2,0
14023,2014-03-01,"04,13,15,29,33","05,09",4,13,15,29,33,5,9,94,29,4,1,14,4,2,0,1,2,2,1,1
14024,2014-03-03,"07,11,15,31,32","06,11",7,11,15,31,32,6,11,96,25,4,1,17,5,1,1,2,1,2,1,1
14025,2014-03-05,"19,20,27,32,34","06,08",19,20,27,32,34,6,8,132,15,2,3,14,2,0,2,0,2,3,1,1
14026,2014-03-08,"05,10,12,15,26","04,08",5,10,12,15,26,4,8,68,21,2,3,12,4,0,2,3,1,1,1,1
14027,2014-03-10,"09,10,24,28,29","10,12",9,10,24,28,29,10,12,100,20,2,3,22,2,0,2,2,1,2,2,0
14028,2014-03-12,"03,10,20,25,30","10,12",3,10,20,25,30,10,12,88,27,2,3,22,2,0,2,2,1,2,2,0
14029,2014-03-15,"03,21,22,23,35","05,09",3,21,22,23,35,5,9,104,32,4,1,14,4,2,0,1,3,1,1,1
14030,2014-03-17,"03,14,18,29,35","11,12",3,14,18,29,35,11,12,99,32,3,2,23,1,1,1,1,2,2,2,0
14031,2014-03-19,"06,15,27,32,33","03,04",6,15,27,32,33,3,4,113,27,3,2,7,1,1,1,1,1,3,0,2
14032,2014-03-22,"02,05,06,09,31","02,09",2,5,6,9,31,2,9,53,29,3,2,11,7,1,1,4,0,1,1,1
14033,2014-03-24,"01,07,08,28,29","04,08",1,7,8,28,29,4,8,73,28,3,2,12,4,0,2,3,0,2,1,1
14034,2014-03-26,"03,11,14,27,32","05,07",3,11,14,27,32,5,7,87,29,3,2,12,2,2,0,2,1,2,1,1
14035,2014-03-29,"09,12,14,28,29","03,10",9,12,14,28,29,3,10,92,20,2,3,13,7,1,1,2,1,2,1,1
14036,2014-03-31,"01,02,12,17,29","03,08",1,2,12,17,29,3,8,61,28,3,2,11,5,1,1,3,1,1,1,1
14037,2014-04-02,"03,04,08,19,34","02,04",3,4,8,19,34,2,4,68,31,2,3,6,2,0,2,3,1,1,0,2
14038,2014-04-05,"07,08,12,20,32","03,05",7,8,12,20,32,3,5,79,25,1,4,8,2,2,0,3,1,1,0,2
14039,2014-04-07,"02,05,11,15,20","08,11",2,5,11,15,20,8,11,53,18,3,2,19,3,1,1,3,2,0,2,0
14040,2014-04-09,"12,15,21,30,33","02,08",12,15,21,30,33,2,8,111,21,3,2,10,6,0,2,1,2,2,1,1
14041,2014-04-12,"05,07,11,15,18","05,12",5,7,11,15,18,5,12,56,13,4,1,17,7,1,1,3,2,0,1,1
14042,2014-04-14,"16,21,25,27,35","06,11",16,21,25,27,35,6,11,124,19,4,1,17,5,1,1,0,2,3,1,1
14043,2014-04-16,"01,11,23,29,30","01,12",1,11,23,29,30,1,12,94,29,4,1,13,11,1,1,2,1,2,1,1
14044,2014-04-19,"22,23,25,27,35","03,11",22,23,25,27,35,3,11,132,13,4,1,14,8,2,0,0,2,3,1,1
14045,2014-04-21,"06,10,12,16,30","02,11",6,10,12,16,30,2,11,74,24,0,5,13,9,1,1,3,1,1,1,1
14046,2014-04-23,"03,15,18,21,26","01,06",3,15,18,21,26,1,6,83,23,3,2,7,5,1,1,1,3,1,0,2
14047,2014-04-26,"06,17,18,30,34","06,12",6,17,18,30,34,6,12,105,28,1,4,18,6,0,2,1,2,2,1,1
14048,2014-04-28,"01,02,05,15,35","01,11",1,2,5,15,35,1,11,58,34,4,1,12,10,2,0,3,1,1,1,1
14049,2014-04-30,"03,15,17,22,31","03,05",3,15,17,22,31,3,5,88,28,4,1,8,2,2,0,1,3,1,0,2
14050,2014-05-03,"10,18,27,28,35","01,06",10,18,27,28,35,1,6,118,25,2,3,7,5,1,1,1,1,3,0,2
14051,2014-05-05,"01,07,11,29,30","03,11",1,7,11,29,30,3,11,78,29,4,1,14,8,2,0,3,0,2,1,1
14052,2014-05-07,"14,19,21,24,30","02,07",14,19,21,24,30,2,7,108,16,2,3,9,5,1,1,0,4,1,1,1
14053,2014-05-10,"02,11,17,27,30","03,04",2,11,17,27,30,3,4,87,28,3,2,7,1,1,1,2,1,2,0,2
14054,2014-05-12,"02,03,20,25,34","01,12",2,3,20,25,34,1,12,84,32,2,3,13,11,1,1,2,1,2,1,1
14055,2014-05-14,"04,23,26,27,35","10,11",4,23,26,27,35,10,11,115,31,3,2,21,1,1,1,1,1,3,2,0
14056,2014-05-17,"12,18,28,29,35","07,08",12,18,28,29,35,7,8,122,23,2,3,15,1,1,1,1,1,3,2,0
14057,2014-05-19,"08,10,20,27,33","01,09",8,10,20,27,33,1,9,98,25,2,3,10,8,2,0,2,1,2,1,1
14058,2014-05-21,"09,15,22,24,26","02,07",9,15,22,24,26,2,7,96,17,2,3,9,5,1,1,1,3,1,1,1
14059,2014-05-24,"07,15,17,25,29","04,11",7,15,17,25,29,4,11,93,22,5,0,15,7,1,1,1,2,2,1,1
14060,2014-05-26,"12,22,29,30,34","05,11",12,22,29,30,34,5,11,127,22,1,4,16,6,2,0,1,1,3,1,1
14061,2014-05-28,"04,11,17,20,29","06,10",4,11,17,20,29,6,10,81,25,3,2,16,4,0,2,2,2,1,1,1
14062,2014-05-31,"04,07,17,24,25","02,04",4,7,17,24,25,2,4,77,21,3,2,6,2,0,2,2,2,1,0,2
14063,2014-06-02,"11,17,21,23,34","03,04",11,17,21,23,34,3,4,106,23,4,1,7,1,1,1,1,3,1,0,2
14064,2014-06-04,"08,15,33,34,35","01,08",8,15,33,34,35,1,8,125,27,3,2,9,7,1,1,1,1,3,1,1
14065,2014-06-07,"07,12,19,31,33","07,12",7,12,19,31,33,7,12,102,26,4,1,19,5,1,1,2,1,2,2,0
14066,2014-06-09,"08,14,16,20,31","03,11",8,14,16,20,31,3,11,89,23,1,4,14,8,2,0,1,3,1,1,1
14067,2014-06-11,"03,18,23,24,31","03,07",3,18,23,24,31,3,7,99,28,3,2,10,4,2,0,1,3,1,1,1
14068,2014-06-14,"05,15,24,29,35","05,06",5,15,24,29,35,5,6,108,30,4,1,11,1,1,1,1,2,2,0,2
14069,2014-06-16,"16,22,27,29,31","02,09",16,22,27,29,31,2,9,125,15,3,2,11,7,1,1,0,2,3,1,1
14070,2014-06-18,"01,02,07,10,32","04,12",1,2,7,10,32,4,12,52,31,2,3,16,8,0,2,4,0,1,1,1
14071,2014-06-21,"04,14,15,22,23","01,07",4,14,15,22,23,1,7,78,19,2,3,8,6,2,0,1,4,0,1,1
14072,2014-06-23,"17,19,22,24,30","02,09",17,19,22,24,30,2,9,112,13,2,3,11,7,1,1,0,4,1,1,1
14073,2014-06-25,"04,05,07,13,35","05,06",4,5,7,13,35,5,6,64,31,4,1,11,1,1,1,3,1,1,0,2
14074,2014-06-28,"06,11,22,27,30","05,11",6,11,22,27,30,5,11,96,24,2,3,16,6,2,0,2,1,2,1,1
14075,2014-06-30,"05,07,29,32,35","04,10",5,7,29,32,35,4,10,108,30,4,1,14,6,0,2,2,0,3,1,1
14076,2014-07-02,"05,10,19,31,32","09,10",5,10,19,31,32,9,10,97,27,3,2,19,1,1,1,2,1,2,2,0
14077,2014-07-05,"09,16,26,31,32","01,05",9,16,26,31,32,1,5,114,23,2,3,6,4,2,0,1,1,3,0,2
14078,2014-07-07,"10,15,16,22,28","04,05",10,15,16,22,28,4,5,91,18,1,4,9,1,1,1,1,3,1,0,2
14079,2014-07-09,"09,10,20,31,32","06,10",9,10,20,31,32,6,10,102,23,2,3,16,4,0,2,2,1,2,1,1
14080,2014-07-12,"17,20,23,25,27","03,10",17,20,23,25,27,3,10,112,10,4,1,13,7,1,1,0,3,2,1,1
14081,2014-07-14,"03,05,08,10,25","09,12",3,5,8,10,25,9,12,51,22,3,2,21,3,1,1,4,0,1,2,0
14082,2014-07-16,"01,08,18,23,25","08,12",1,8,18,23,25,8,12,75,24,3,2,20,4,0,2,2,2,1,2,0
14083,2014-07-19,"18,20,24,33,35","05,10",18,20,24,33,35,5,10,130,17,2,3,15,5,1,1,0,3,2,1,1
14084,2014-07-21,"02,07,09,11,28","05,09",2,7,9,11,28,5,9,57,26,3,2,14,4,2,0,4,0,1,1,1
14085,2014-07-23,"06,12,13,25,29","11,12",6,12,13,25,29,11,12,85,23,3,2,23,1,1,1,2,1,2,2,0
14086,2014-07-26,"06,08,27,29,35","03,09",6,8,27,29,35,3,9,105,29,3,2,12,6,2,0,2,0,3,1,1
14087,2014-07-28,"04,07,31,33,35","09,10",4,7,31,33,35,9,10,110,31,4,1,19,1,1,1,2,0,3,2,0
14088,2014-07-30,"07,13,20,25,26","08,11",7,13,20,25,26,8,11,91,19,3,2,19,3,1,1,1,2,2,2,0
14089,2014-08-02,"02,08,12,29,30","07,12",2,8,12,29,30,7,12,81,28,1,4,19,5,1,1,3,0,2,2,0
14090,2014-08-04,"02,03,20,23,28","06,08",2,3,20,23,28,6,8,76,26,2,3,14,2,0,2,2,2,1,1,1
14091,2014-08-06,"10,16,18,29,32","02,07",10,16,18,29,32,2,7,105,22,1,4,9,5,1,1,1,2,2,1,1
14092,2014-08-09,"02,18,27,30,32","05,11",2,18,27,30,32,5,11,109,30,1,4,16,6,2,0,1,1,3,1,1
14093,2014-08-11,"03,08,30,32,34","09,11",3,8,30,32,34,9,11,107,31,1,4,20,2,2,0,2,0,3,2,0
14094,2014-08-13,"13,14,24,25,34","04,07",13,14,24,25,34,4,7,110,21,2,3,11,3,1,1,0,3,2,1,1
14095,2014-08-16,"06,22,30,31,34","05,06",6,22,30,31,34,5,6,123,28,1,4,11,1,1,1,1,1,3,0,2
14096,2014-08-18,"03,07,21,23,31","05,10",3,7,21,23,31,5,10,85,28,5,0,15,5,1,1,2,2,1,1,1
14097,2014-08-20,"03,15,20,21,23","07,09",3,15,20,21,23,7,9,82,20,4,1,16,2,2,0,1,4,0,2,0
14098,2014-08-23,"16,18,22,25,35","03,10",16,18,22,25,35,3,10,116,19,2,3,13,7,1,1,0,3,2,1,1
14099,2014-08-25,"15,21,22,23,33","01,07",15,21,22,23,33,1,7,114,18,4,1,8,6,2,0,0,4,1,1,1
14100,2014-08-27,"02,04,08,12,35","01,07",2,4,8,12,35,1,7,61,33,1,4,8,6,2,0,4,0,1,1,1
14101,2014-08-30,"09,10,12,17,28","03,11",9,10,12,17,28,3,11,76,19,2,3,14,8,2,0,3,1,1,1,1
14102,2014-09-01,"01,07,14,19,20","03,12",1,7,14,19,20,3,12,61,19,3,2,15,9,1,1,2,3,0,1,1
14103,2014-09-03,"14,20,23,25,26","10,12",14,20,23,25,26,10,12,108,12,2,3,22,2,0,2,0,3,2,2,0
14104,2014-09-06,"07,13,14,28,32","04,11",7,13,14,28,32,4,11,94,25,2,3,15,7,1,1,1,2,2,1,1
14105,2014-09-08,"04,10,26,29,32","04,08",4,10,26,29,32,4,8,101,28,1,4,12,4,0,2,2,0,3,1,1
14106,2014-09-10,"05,09,11,20,22","05,11",5,9,11,20,22,5,11,67,17,3,2,16,6,2,0,3,2,0,1,1
14107,2014-09-13,"05,13,14,21,34","08,10",5,13,14,21,34,8,10,87,29,3,2,18,2,0,2,1,3,1,2,0
14108,2014-09-15,"01,02,13,23,35","09,12",1,2,13,23,35,9,12,74,34,4,1,21,3,1,1,2,2,1,2,0
14109,2014-09-17,"15,18,20,21,23","01,02",15,18,20,21,23,1,2,97,8,3,2,3,1,1,1,0,5,0,0,2
14110,2014-09-20,"09,18,19,22,24","08,11",9,18,19,22,24,8,11,92,15,2,3,19,3,1,1,1,4,0,2,0
14111,2014-09-22,"11,16,18,20,29","03,04",11,16,18,20,29,3,4,94,18,2,3,7,1,1,1,1,3,1,0,2
14112,2014-09-24,"03,05,14,18,32","02,10",3,5,14,18,32,2,10,72,29,2,3,12,8,0,2,2,2,1,1,1
14113,2014-09-27,"02,13,17,19,23","01,06",2,13,17,19,23,1,6,74,21,4,1,7,5,1,1,1,4,0,0,2
14114,2014-09-29,"03,16,24,30,33","05,08",3,16,24,30,33,5,8,106,30,2,3,13,3,1,1,1,2,2,1,1
14115,2014-10-01,"01,05,26,29,30","02,10",1,5,26,29,30,2,10,91,29,3,2,12,8,0,2,2,0,3,1,1
14116,2014-10-04,"06,13,15,24,27","04,05",6,13,15,24,27,4,5,85,21,3,2,9,1,1,1,1,3,1,0,2
14117,2014-10-06,"03,14,17,18,33","06,09",3,14,17,18,33,6,9,85,30,3,2,15,3,1,1,1,3,1,1,1
14118,2014-10-08,"02,03,23,24,26","05,11",2,3,23,24,26,5,11,78,24,2,3,16,6,2,0,2,2,1,1,1
14119,2014-10-11,"04,08,09,13,18","08,12",4,8,9,13,18,8,12,52,14,2,3,20,4,0,2,3,2,0,2,0
14120,2014-10-13,"01,04,06,18,33","05,11",1,4,6,18,33,5,11,62,32,2,3,16,6,2,0,3,1,1,1,1
14121,2014-10-15,"13,16,18,22,32","08,10",13,16,18,22,32,8,10,101,19,1,4,18,2,0,2,0,4,1,2,0
14122,2014-10-18,"03,10,25,26,35","01,07",3,10,25,26,35,1,7,99,32,3,2,8,6,2,0,2,0,3,1,1
14123,2014-10-20,"01,09,12,22,25","02,09",1,9,12,22,25,2,9,69,24,3,2,11,7,1,1,3,1,1,1,1
14124,2014-10-22,"01,03,28,29,35","08,12",1,3,28,29,35,8,12,96,34,4,1,20,4,0,2,2,0,3,2,0
14125,2014-10-25,"12,15,19,23,31","04,10",12,15,19,23,31,4,10,100,19,4,1,14,6,0,2,1,3,1,1,1
14126,2014-10-27,"02,09,22,30,34","09,10",2,9,22,30,34,9,10,97,32,1,4,19,1,1,1,2,1,2,2,0
14127,2014-10-29,"02,04,06,15,19","02,11",2,4,6,15,19,2,11,46,17,2,3,13,9,1,1,3,2,0,1,1
14128,2014-11-01,"02,04,16,22,34","08,11",2,4,16,22,34,8,11,78,32,0,5,19,3,1,1,2,2,1,2,0
14129,2014-11-03,"07,22,28,30,32","05,06",7,22,28,30,32,5,6,119,25,1,4,11,1,1,1,1,1,3,0,2
14130,2014-11-05,"02,18,31,32,33","05,07",2,18,31,32,33,5,7,116,31,2,3,12,2,2,0,1,1,3,1,1
14131,2014-11-08,"03,16,19,23,27","03,07",3,16,19,23,27,3,7,88,24,4,1,10,4,2,0,1,3,1,1,1
14132,2014-11-10,"01,03,04,19,32","01,07",1,3,4,19,32,1,7,59,31,3,2,8,6,2,0,3,1,1,1,1
14133,2014-11-12,"02,08,12,14,18","04,12",2,8,12,14,18,4,12,54,16,0,5,16,8,0,2,3,2,0,1,1
14134,2014-11-15,"02,05,07,11,32","09,12",2,5,7,11,32,9,12,57,30,3,2,21,3,1,1,4,0,1,2,0
14135,2014-11-17,"20,26,28,30,35","09,12",20,26,28,30,35,9,12,139,15,1,4,21,3,1,1,0,1,4,2,0
14136,2014-11-19,"04,18,20,34,35","07,11",4,18,20,34,35,7,11,111,31,1,4,18,4,2,0,1,2,2,2,0
14137,2014-11-22,"02,11,16,22,34","02,05",2,11,16,22,34,2,5,85,32,1,4,7,3,1,1,2,2,1,0,2
14138,2014-11-24,"01,07,29,32,34","09,12",1,7,29,32,34,9,12,103,33,3,2,21,3,1,1,2,0,3,2,0
14139,2014-11-26,"03,05,07,15,34","01,10",3,5,7,15,34,1,10,64,31,4,1,11,9,1,1,3,1,1,1,1
14140,2014-11-29,"01,19,20,25,34","07,12",1,19,20,25,34,7,12,99,33,3,2,19,5,1,1,1,2,2,2,0
14141,2014-12-01,"04,17,20,26,29","05,08",4,17,20,26,29,5,8,96,25,2,3,13,3,1,1,1,2,2,1,1
14142,2014-12-03,"18,21,25,28,30","04,06",18,21,25,28,30,4,6,122,12,2,3,10,2,0,2,0,2,3,0,2
14143,2014-12-06,"01,11,14,18,25","06,10",1,11,14,18,25,6,10,69,24,3,2,16,4,0,2,2,2,1,1,1
14144,2014-12-08,"01,21,24,25,35","04,11",1,21,24,25,35,4,11,106,34,4,1,15,7,1,1,1,2,2,1,1
14145,2014-12-10,"15,19,22,24,26","10,11",15,19,22,24,26,10,11,106,11,2,3,21,1,1,1,0,4,1,2,0
14146,2014-12-13,"02,16,23,24,28","10,11",2,16,23,24,28,10,11,93,26,1,4,21,1,1,1,1,3,1,2,0
14147,2014-12-15,"05,09,14,26,34","02,09",5,9,14,26,34,2,9,88,29,2,3,11,7,1,1,2,1,2,1,1
14148,2014-12-17,"03,09,10,11,20","07,09",3,9,10,11,20,7,9,53,17,3,2,16,2,2,0,4,1,0,2,0
14149,2014-12-20,"02,13,19,26,35","01,05",2,13,19,26,35,1,5,95,33,3,2,6,4,2,0,1,2,2,0,2
14150,2014-12-22,"19,21,30,33,35","05,07",19,21,30,33,35,5,7,138,16,4,1,12,2,2,0,0,2,3,1,1
14151,2014-12-24,"03,08,26,31,32","08,12",3,8,26,31,32,8,12,100,29,2,3,20,4,0,2,2,0,3,2,0
14152,2014-12-27,"05,12,18,24,33","01,05",5,12,18,24,33,1,5,92,28,2,3,6,4,2,0,2,2,1,0,2
14153,2014-12-29,"01,08,13,24,32","05,10",1,8,13,24,32,5,10,78,31,2,3,15,5,1,1,2,2,1,1,1
14154,2014-12-31,"05,12,17,23,28","02,09",5,12,17,23,28,2,9,85,23,3,2,11,7,1,1,2,2,1,1,1
15001,2015-01-03,"08,09,19,27,30","06,07",8,9,19,27,30,6,7,93,22,3,2,13,1,1,1,2,1,2,1,1
15002,2015-01-05,"03,14,20,26,32","06,10",3,14,20,26,32,6,10,95,29,1,4,16,4,0,2,1,2,2,1,1
15003,2015-01-07,"12,19,27,28,34","01,12",12,19,27,28,34,1,12,120,22,2,3,13,11,1,1,1,1,3,1,1
15004,2015-01-10,"03,12,14,18,28","05,06",3,12,14,18,28,5,6,75,25,1,4,11,1,1,1,2,2,1,0,2
15005,2015-01-12,"11,14,15,18,19","07,08",11,14,15,18,19,7,8,77,8,3,2,15,1,1,1,1,4,0,2,0
15006,2015-01-14,"06,08,30,32,33","03,07",6,8,30,32,33,3,7,109,27,1,4,10,4,2,0,2,0,3,1,1
15007,2015-01-17,"02,07,08,14,31","04,08",2,7,8,14,31,4,8,62,29,2,3,12,4,0,2,3,1,1,1,1
15008,2015-01-19,"07,10,11,15,17","03,10",7,10,11,15,17,3,10,60,10,4,1,13,7,1,1,3,2,0,1,1
15009,2015-01-21,"17,22,26,27,33","06,10",17,22,26,27,33,6,10,125,16,3,2,16,4,0,2,0,2,3,1,1
15010,2015-01-24,"02,06,17,30,35","02,07",2,6,17,30,35,2,7,90,33,2,3,9,5,1,1,2,1,2,1,1
15011,2015-01-26,"04,13,22,25,30","01,06",4,13,22,25,30,1,6,94,26,2,3,7,5,1,1,1,2,2,0,2
15012,2015-01-28,"03,04,06,11,31","05,09",3,4,6,11,31,5,9,55,28,3,2,14,4,2,0,4,0,1,1,1
15013,2015-01-31,"11,15,25,28,35","07,10",11,15,25,28,35,7,10,114,24,4,1,17,3,1,1,1,1,3,2,0
15014,2015-02-02,"08,16,25,29,35","03,10",8,16,25,29,35,3,10,113,27,3,2,13,7,1,1,1,1,3,1,1
15015,2015-02-04,"01,05,13,17,32","04,11",1,5,13,17,32,4,11,68,31,4,1,15,7,1,1,2,2,1,1,1
15016,2015-02-07,"06,07,16,20,34","09,11",6,7,16,20,34,9,11,83,28,1,4,20,2,2,0,2,2,1,2,0
15017,2015-02-09,"07,13,16,17,29","01,07",7,13,16,17,29,1,7,82,22,4,1,8,6,2,0,1,3,1,1,1
15018,2015-02-11,"04,07,10,23,31","03,07",4,7,10,23,31,3,7,75,27,3,2,10,4,2,0,3,1,1,1,1
15019,2015-02-14,"02,08,16,22,24","01,03",2,8,16,22,24,1,3,72,22,0,5,4,2,2,0,2,3,0,0,2
15020,2015-02-16,"11,26,28,29,32","01,04",11,26,28,29,32,1,4,126,21,2,3,5,3,1,1,1,0,4,0,2
15021,2015-02-25,"22,23,24,26,31","05,06",22,23,24,26,31,5,6,126,9,2,3,11,1,1,1,0,3,2,0,2
15022,2015-02-28,"09,11,14,15,26","11,12",9,11,14,15,26,11,12,75,17,3,2,23,1,1,1,2,2,1,2,0
15023,2015-03-02,"06,09,11,12,22","03,11",6,9,11,12,22,3,11,60,16,2,3,14,8,2,0,4,1,0,1,1
15024,2015-03-04,"02,06,08,16,34","03,04",2,6,8,16,34,3,4,66,32,0,5,7,1,1,1,3,1,1,0,2
15025,2015-03-07,"07,10,20,22,27","10,11",7,10,20,22,27,10,11,86,20,2,3,21,1,1,1,2,2,1,2,0
15026,2015-03-09,"11,13,14,15,22","02,08",11,13,14,15,22,2,8,75,11,3,2,10,6,0,2,1,4,0,1,1
15027,2015-03-11,"05,21,22,25,28","03,10",5,21,22,25,28,3,10,101,23,3,2,13,7,1,1,1,2,2,1,1
15028,2015-03-14,"03,09,28,32,33","09,10",3,9,28,32,33,9,10,105,30,3,2,19,1,1,1,2,0,3,2,0
15029,2015-03-16,"07,10,19,30,35","03,05",7,10,19,30,35,3,5,101,28,3,2,8,2,2,0,2,1,2,0,2
15030,2015-03-18,"09,18,19,26,31","02,05",9,18,19,26,31,2,5,103,22,3,2,7,3,1,1,1,2,2,0,2
15031,2015-03-21,"07,21,29,32,33","04,12",7,21,29,32,33,4,12,122,26,4,1,16,8,0,2,1,1,3,1,1
15032,2015-03-23,"06,21,25,27,30","07,11",6,21,25,27,30,7,11,109,24,3,2,18,4,2,0,1,1,3,2,0
15033,2015-03-25,"03,17,22,26,28","03,07",3,17,22,26,28,3,7,96,25,2,3,10,4,2,0,1,2,2,1,1
15034,2015-03-28,"04,08,15,18,26","05,09",4,8,15,18,26,5,9,71,22,1,4,14,4,2,0,2,2,1,1,1
15035,2015-03-30,"22,24,29,30,35","01,10",22,24,29,30,35,1,10,140,13,2,3,11,9,1,1,0,2,3,1,1
15036,2015-04-01,"14,18,20,23,24","04,08",14,18,20,23,24,4,8,99,10,1,4,12,4,0,2,0,5,0,1,1
15037,2015-04-04,"10,16,21,28,31","07,08",10,16,21,28,31,7,8,106,21,2,3,15,1,1,1,1,2,2,2,0
15038,2015-04-06,"12,19,22,31,35","07,08",12,19,22,31,35,7,8,119,23,3,2,15,1,1,1,1,2,2,2,0
15039,2015-04-08,"03,06,07,16,25","01,06",3,6,7,16,25,1,6,57,22,3,2,7,5,1,1,3,1,1,0,2
15040,2015-04-11,"02,09,10,23,35","09,12",2,9,10,23,35,9,12,79,33,3,2,21,3,1,1,3,1,1,2,0
15041,2015-04-13,"01,11,21,23,28","01,10",1,11,21,23,28,1,10,84,27,4,1,11,9,1,1,2,2,1,1,1
15042,2015-04-15,"03,07,12,17,24","02,11",3,7,12,17,24,2,11,63,21,3,2,13,9,1,1,3,2,0,1,1
15043,2015-04-18,"02,20,22,25,29","02,07",2,20,22,25,29,2,7,98,27,2,3,9,5,1,1,1,2,2,1,1
15044,2015-04-20,"16,18,27,31,33","01,03",16,18,27,31,33,1,3,125,17,3,2,4,2,2,0,0,2,3,0,2
15045,2015-04-22,"08,09,22,29,30","08,12",8,9,22,29,30,8,12,98,22,2,3,20,4,0,2,2,1,2,2,0
15046,2015-04-25,"05,07,10,22,26","04,10",5,7,10,22,26,4,10,70,21,2,3,14,6,0,2,3,1,1,1,1
15047,2015-04-27,"01,02,17,23,31","05,12",1,2,17,23,31,5,12,74,30,4,1,17,7,1,1,2,2,1,1,1
15048,2015-04-29,"10,11,22,24,33","02,09",10,11,22,24,33,2,9,100,23,2,3,11,7,1,1,2,2,1,1,1
15049,2015-05-02,"08,09,11,15,22","08,10",8,9,11,15,22,8,10,65,14,3,2,18,2,0,2,3,2,0,2,0
15050,2015-05-04,"06,07,10,20,28","02,07",6,7,10,20,28,2,7,71,22,1,4,9,5,1,1,3,1,1,1,1
15051,2015-05-06,"01,02,11,16,21","01,05",1,2,11,16,21,1,5,51,20,3,2,6,4,2,0,3,2,0,0,2
15052,2015-05-09,"13,19,24,27,29","07,08",13,19,24,27,29,7,8,112,16,4,1,15,1,1,1,0,3,2,2,0
15053,2015-05-11,"08,25,28,29,32","04,07",8,25,28,29,32,4,7,122,24,2,3,11,3,1,1,1,0,4,1,1
15054,2015-05-13,"02,09,15,24,34","03,09",2,9,15,24,34,3,9,84,32,2,3,12,6,2,0,2,2,1,1,1
15055,2015-05-16,"06,11,14,20,30","05,10",6,11,14,20,30,5,10,81,24,1,4,15,5,1,1,2,2,1,1,1
15056,2015-05-18,"06,12,19,26,35","03,10",6,12,19,26,35,3,10,98,29,2,3,13,7,1,1,2,1,2,1,1
15057,2015-05-20,"01,05,07,14,26","04,06",1,5,7,14,26,4,6,53,25,3,2,10,2,0,2,3,1,1,0,2
15058,2015-05-23,"10,14,20,27,30","07,12",10,14,20,27,30,7,12,101,20,1,4,19,5,1,1,1,2,2,2,0
15059,2015-05-25,"07,09,19,23,32","01,03",7,9,19,23,32,1,3,90,25,4,1,4,2,2,0,2,2,1,0,2
15060,2015-05-27,"16,24,25,26,33","04,11",16,24,25,26,33,4,11,124,17,2,3,15,7,1,1,0,2,3,1,1
15061,2015-05-30,"06,07,08,16,22","02,10",6,7,8,16,22,2,10,59,16,1,4,12,8,0,2,3,2,0,1,1
15062,2015-06-01,"06,07,13,14,15","01,04",6,7,13,14,15,1,4,55,9,3,2,5,3,1,1,2,3,0,0,2
15063,2015-06-03,"01,04,06,34,35","02,04",1,4,6,34,35,2,4,80,34,2,3,6,2,0,2,3,0,2,0,2
15064,2015-06-06,"02,08,20,28,31","07,10",2,8,20,28,31,7,10,89,29,1,4,17,3,1,1,2,1,2,2,0
15065,2015-06-08,"04,05,07,13,35","08,11",4,5,7,13,35,8,11,64,31,4,1,19,3,1,1,3,1,1,2,0
15066,2015-06-10,"01,03,07,13,29","02,10",1,3,7,13,29,2,10,53,28,5,0,12,8,0,2,3,1,1,1,1
15067,2015-06-13,"04,10,18,24,27","04,11",4,10,18,24,27,4,11,83,23,1,4,15,7,1,1,2,2,1,1,1
15068,2015-06-15,"02,03,20,31,35","04,08",2,3,20,31,35,4,8,91,33,3,2,12,4,0,2,2,1,2,1,1
15069,2015-06-17,"02,09,11,22,25","01,07",2,9,11,22,25,1,7,69,23,3,2,8,6,2,0,3,1,1,1,1
15070,2015-06-20,"03,09,12,17,18","04,12",3,9,12,17,18,4,12,59,15,3,2,16,8,0,2,3,2,0,1,1
15071,2015-06-22,"04,06,13,16,34","04,10",4,6,13,16,34,4,10,73,30,1,4,14,6,0,2,2,2,1,1,1
15072,2015-06-24,"19,20,21,31,33","09,10",19,20,21,31,33,9,10,124,14,4,1,19,1,1,1,0,3,2,2,0
15073,2015-06-27,"09,26,27,30,34","01,06",9,26,27,30,34,1,6,126,25,2,3,7,5,1,1,1,0,4,0,2
15074,2015-06-29,"01,12,21,27,33","04,09",1,12,21,27,33,4,9,94,32,4,1,13,5,1,1,2,1,2,1,1
15075,2015-07-01,"13,14,26,27,33","10,12",13,14,26,27,33,10,12,113,20,3,2,22,2,0,2,0,2,3,2,0
15076,2015-07-04,"03,19,21,31,34","05,12",3,19,21,31,34,5,12,108,31,4,1,17,7,1,1,1,2,2,1,1
15077,2015-07-06,"01,16,17,22,28","02,09",1,16,17,22,28,2,9,84,27,2,3,11,7,1,1,1,3,1,1,1
15078,2015-07-08,"19,24,26,28,33","01,02",19,24,26,28,33,1,2,130,14,2,3,3,1,1,1,0,2,3,0,2
15079,2015-07-11,"01,09,17,23,24","04,05",1,9,17,23,24,4,5,74,23,4,1,9,1,1,1,2,3,0,0,2
15080,2015-07-13,"14,20,29,30,32","03,08",14,20,29,30,32,3,8,125,18,1,4,11,5,1,1,0,2,3,1,1
15081,2015-07-15,"03,04,10,13,17","05,09",3,4,10,13,17,5,9,47,14,3,2,14,4,2,0,3,2,0,1,1
15082,2015-07-18,"08,15,28,31,33","03,06",8,15,28,31,33,3,6,115,25,3,2,9,3,1,1,1,1,3,0,2
15083,2015-07-20,"14,16,19,25,29","10,12",14,16,19,25,29,10,12,103,15,3,2,22,2,0,2,0,3,2,2,0
15084,2015-07-22,"10,20,21,32,34","06,07",10,20,21,32,34,6,7,117,24,1,4,13,1,1,1,1,2,2,1,1
15085,2015-07-25,"02,03,04,06,16","03,12",2,3,4,6,16,3,12,31,14,1,4,15,9,1,1,4,1,0,1,1
15086,2015-07-27,"05,09,11,15,32","04,09",5,9,11,15,32,4,9,72,27,4,1,13,5,1,1,3,1,1,1,1
15087,2015-07-29,"02,05,15,17,22","01,11",2,5,15,17,22,1,11,61,20,3,2,12,10,2,0,2,3,0,1,1
15088,2015-08-01,"05,15,28,31,34","11,12",5,15,28,31,34,11,12,113,29,3,2,23,1,1,1,1,1,3,2,0
15089,2015-08-03,"05,12,18,20,27","10,12",5,12,18,20,27,10,12,82,22,2,3,22,2,0,2,2,2,1,2,0
15090,2015-08-05,"06,09,11,17,21","06,08",6,9,11,17,21,6,8,64,15,4,1,14,2,0,2,3,2,0,1,1
15091,2015-08-08,"02,07,28,29,30","03,07",2,7,28,29,30,3,7,96,28,2,3,10,4,2,0,2,0,3,1,1
15092,2015-08-10,"02,14,21,27,34","05,08",2,14,21,27,34,5,8,98,32,2,3,13,3,1,1,1,2,2,1,1
15093,2015-08-12,"16,17,25,26,27","02,04",16,17,25,26,27,2,4,111,11,3,2,6,2,0,2,0,2,3,0,2
15094,2015-08-15,"02,03,10,11,29","03,07",2,3,10,11,29,3,7,55,27,3,2,10,4,2,0,4,0,1,1,1
15095,2015-08-17,"08,14,26,34,35","05,10",8,14,26,34,35,5,10,117,27,1,4,15,5,1,1,1,1,3,1,1
15096,2015-08-19,"03,09,12,18,21","02,06",3,9,12,18,21,2,6,63,18,3,2,8,4,0,2,3,2,0,0,2
15097,2015-08-22,"04,16,17,26,27","01,04",4,16,17,26,27,1,4,90,23,2,3,5,3,1,1,1,2,2,0,2
15098,2015-08-24,"09,14,21,27,33","06,09",9,14,21,27,33,6,9,104,24,4,1,15,3,1,1,1,2,2,1,1
15099,2015-08-26,"09,12,14,22,25","05,10",9,12,14,22,25,5,10,82,16,2,3,15,5,1,1,2,2,1,1,1
15100,2015-08-29,"09,15,18,23,32","05,07",9,15,18,23,32,5,7,97,23,3,2,12,2,2,0,1,3,1,1,1
15101,2015-08-31,"06,12,17,18,32","07,12",6,12,17,18,32,7,12,85,26,1,4,19,5,1,1,2,2,1,2,0
15102,2015-09-02,"11,14,15,33,34","03,12",11,14,15,33,34,3,12,107,23,3,2,15,9,1,1,1,2,2,1,1
15103,2015-09-05,"07,09,15,25,34","04,10",7,9,15,25,34,4,10,90,27,4,1,14,6,0,2,2,1,2,1,1
15104,2015-09-07,"16,19,25,30,34","04,09",16,19,25,30,34,4,9,124,18,2,3,13,5,1,1,0,2,3,1,1
15105,2015-09-09,"08,09,15,21,27","05,09",8,9,15,21,27,5,9,80,19,4,1,14,4,2,0,2,2,1,1,1
15106,2015-09-12,"02,11,13,22,30","02,03",2,11,13,22,30,2,3,78,28,2,3,5,1,1,1,2,2,1,0,2
15107,2015-09-14,"03,23,25,28,29","06,07",3,23,25,28,29,6,7,108,26,4,1,13,1,1,1,1,1,3,1,1
15108,2015-09-16,"01,13,16,26,31","07,12",1,13,16,26,31,7,12,87,30,3,2,19,5,1,1,1,2,2,2,0
15109,2015-09-19,"01,06,11,22,31","03,12",1,6,11,22,31,3,12,71,30,3,2,15,9,1,1,3,1,1,1,1
15110,2015-09-21,"02,07,10,22,30","07,11",2,7,10,22,30,7,11,71,28,1,4,18,4,2,0,3,1,1,2,0
15111,2015-09-23,"07,08,16,24,28","03,10",7,8,16,24,28,3,10,83,21,1,4,13,7,1,1,2,2,1,1,1
15112,2015-09-26,"04,05,15,19,28","04,11",4,5,15,19,28,4,11,71,24,3,2,15,7,1,1,2,2,1,1,1
15113,2015-09-28,"01,14,21,29,33","02,10",1,14,21,29,33,2,10,98,32,4,1,12,8,0,2,1,2,2,1,1
15114,2015-09-30,"09,18,24,31,34","02,10",9,18,24,31,34,2,10,116,25,2,3,12,8,0,2,1,2,2,1,1
15115,2015-10-03,"08,12,13,14,16","03,09",8,12,13,14,16,3,9,63,8,1,4,12,6,2,0,2,3,0,1,1
15116,2015-10-05,"07,10,19,24,33","03,07",7,10,19,24,33,3,7,93,26,3,2,10,4,2,0,2,2,1,1,1
15117,2015-10-07,"06,17,20,30,33","10,11",6,17,20,30,33,10,11,106,27,2,3,21,1,1,1,1,2,2,2,0
15118,2015-10-10,"03,07,20,24,31","04,09",3,7,20,24,31,4,9,85,28,3,2,13,5,1,1,2,2,1,1,1
15119,2015-10-12,"01,08,12,16,21","06,11",1,8,12,16,21,6,11,58,20,2,3,17,5,1,1,3,2,0,1,1
15120,2015-10-14,"01,09,15,24,32","05,10",1,9,15,24,32,5,10,81,31,3,2,15,5,1,1,2,2,1,1,1
15121,2015-10-17,"02,04,17,27,28","04,06",2,4,17,27,28,4,6,78,26,2,3,10,2,0,2,2,1,2,0,2
15122,2015-10-19,"11,13,15,26,35","06,11",11,13,15,26,35,6,11,100,24,4,1,17,5,1,1,1,2,2,1,1
15123,2015-10-21,"04,15,27,29,30","02,10",4,15,27,29,30,2,10,105,26,3,2,12,8,0,2,1,1,3,1,1
15124,2015-10-24,"04,06,12,31,32","03,06",4,6,12,31,32,3,6,85,28,1,4,9,3,1,1,3,0,2,0,2
15125,2015-10-26,"02,03,15,17,28","08,10",2,3,15,17,28,8,10,65,26,3,2,18,2,0,2,2,2,1,2,0
15126,2015-10-28,"04,05,08,09,21","03,06",4,5,8,9,21,3,6,47,17,3,2,9,3,1,1,4,1,0,0,2
15127,2015-10-31,"09,11,14,19,30","03,08",9,11,14,19,30,3,8,83,21,3,2,11,5,1,1,2,2,1,1,1
15128,2015-11-02,"10,12,23,30,32","03,04",10,12,23,30,32,3,4,107,22,1,4,7,1,1,1,2,1,2,0,2
15129,2015-11-04,"01,06,23,25,29","03,09",1,6,23,25,29,3,9,84,28,4,1,12,6,2,0,2,1,2,1,1
15130,2015-11-07,"17,25,31,32,34","02,12",17,25,31,32,34,2,12,139,17,3,2,14,10,0,2,0,1,4,1,1
15131,2015-11-09,"11,17,19,20,27","02,03",11,17,19,20,27,2,3,94,16,4,1,5,1,1,1,1,3,1,0,2
15132,2015-11-11,"03,08,14,18,27","01,05",3,8,14,18,27,1,5,70,24,2,3,6,4,2,0,2,2,1,0,2
15133,2015-11-14,"03,07,08,25,30","04,08",3,7,8,25,30,4,8,73,27,3,2,12,4,0,2,3,0,2,1,1
15134,2015-11-16,"01,02,06,15,35","04,07",1,2,6,15,35,4,7,59,34,3,2,11,3,1,1,3,1,1,1,1
15135,2015-11-18,"05,16,20,25,29","06,08",5,16,20,25,29,6,8,95,24,3,2,14,2,0,2,1,2,2,1,1
15136,2015-11-21,"05,20,23,29,32","02,10",5,20,23,29,32,2,10,109,27,3,2,12,8,0,2,1,2,2,1,1
15137,2015-11-23,"14,17,21,23,26","08,11",14,17,21,23,26,8,11,101,12,3,2,19,3,1,1,0,4,1,2,0
15138,2015-11-25,"01,16,20,29,32","04,07",1,16,20,29,32,4,7,98,31,2,3,11,3,1,1,1,2,2,1,1
15139,2015-11-28,"02,03,05,25,32","05,07",2,3,5,25,32,5,7,67,30,3,2,12,2,2,0,3,0,2,1,1
15140,2015-11-30,"01,11,15,26,35","06,11",1,11,15,26,35,6,11,88,34,4,1,17,5,1,1,2,1,2,1,1
15141,2015-12-02,"02,04,15,19,31","02,03",2,4,15,19,31,2,3,71,29,3,2,5,1,1,1,2,2,1,0,2
15142,2015-12-05,"12,14,22,26,30","03,06",12,14,22,26,30,3,6,104,18,0,5,9,3,1,1,1,2,2,0,2
15143,2015-12-07,"09,20,31,33,35","10,11",9,20,31,33,35,10,11,128,26,4,1,21,1,1,1,1,1,3,2,0
15144,2015-12-09,"01,09,24,26,29","06,11",1,9,24,26,29,6,11,89,28,3,2,17,5,1,1,2,1,2,1,1
15145,2015-12-12,"06,07,20,29,32","11,12",6,7,20,29,32,11,12,94,26,2,3,23,1,1,1,2,1,2,2,0
15146,2015-12-14,"04,15,19,27,31","04,11",4,15,19,27,31,4,11,96,27,4,1,15,7,1,1,1,2,2,1,1
15147,2015-12-16,"01,02,13,18,19","08,10",1,2,13,18,19,8,10,53,18,3,2,18,2,0,2,2,3,0,2,0
15148,2015-12-19,"08,11,27,31,33","08,09",8,11,27,31,33,8,9,110,25,4,1,17,1,1,1,2,0,3,2,0
15149,2015-12-21,"04,06,10,12,28","02,08",4,6,10,12,28,2,8,60,24,0,5,10,6,0,2,4,0,1,1,1
15150,2015-12-23,"04,13,18,25,33","03,07",4,13,18,25,33,3,7,93,29,3,2,10,4,2,0,1,2,2,1,1
15151,2015-12-26,"15,16,18,30,35","01,07",15,16,18,30,35,1,7,114,20,2,3,8,6,2,0,0,3,2,1,1
15152,2015-12-28,"04,05,22,29,35","02,11",4,5,22,29,35,2,11,95,31,3,2,13,9,1,1,2,1,2,1,1
15153,2015-12-30,"01,07,22,27,33","02,11",1,7,22,27,33,2,11,90,32,4,1,13,9,1,1,2,1,2,1,1
16001,2016-01-02,"01,07,19,20,30","05,10",1,7,19,20,30,5,10,77,29,3,2,15,5,1,1,2,2,1,1,1
16002,2016-01-04,"07,12,18,25,35","07,09",7,12,18,25,35,7,9,97,28,3,2,16,2,2,0,2,1,2,2,0
16003,2016-01-06,"04,12,17,22,26","06,07",4,12,17,22,26,6,7,81,22,1,4,13,1,1,1,2,2,1,1,1
16004,2016-01-09,"10,20,23,32,35","09,10",10,20,23,32,35,9,10,120,25,2,3,19,1,1,1,1,2,2,2,0
16005,2016-01-11,"06,09,12,15,20","08,11",6,9,12,15,20,8,11,62,14,2,3,19,3,1,1,3,2,0,2,0
16006,2016-01-13,"14,16,17,22,24","02,09",14,16,17,22,24,2,9,93,10,1,4,11,7,1,1,0,5,0,1,1
16007,2016-01-16,"02,05,14,32,35","01,03",2,5,14,32,35,1,3,88,33,2,3,4,2,2,0,2,1,2,0,2
16008,2016-01-18,"05,12,31,34,35","04,05",5,12,31,34,35,4,5,117,30,3,2,9,1,1,1,2,0,3,0,2
16009,2016-01-20,"05,08,10,17,20","02,12",5,8,10,17,20,2,12,60,15,2,3,14,10,0,2,3,2,0,1,1
16010,2016-01-23,"12,13,15,16,28","02,05",12,13,15,16,28,2,5,84,16,2,3,7,3,1,1,1,3,1,0,2
16011,2016-01-25,"02,08,10,15,23","05,10",2,8,10,15,23,5,10,58,21,2,3,15,5,1,1,3,2,0,1,1
16012,2016-01-27,"05,07,11,23,28","03,12",5,7,11,23,28,3,12,74,23,4,1,15,9,1,1,3,1,1,1,1
16013,2016-01-30,"03,21,23,31,35","02,11",3,21,23,31,35,2,11,113,32,5,0,13,9,1,1,1,2,2,1,1
16014,2016-02-01,"06,08,21,24,27","02,10",6,8,21,24,27,2,10,86,21,2,3,12,8,0,2,2,2,1,1,1
16015,2016-02-03,"01,04,10,13,30","03,09",1,4,10,13,30,3,9,58,29,2,3,12,6,2,0,3,1,1,1,1
16016,2016-02-06,"03,10,22,29,32","02,05",3,10,22,29,32,2,5,96,29,2,3,7,3,1,1,2,1,2,0,2
16017,2016-02-15,"11,18,24,28,29","05,10",11,18,24,28,29,5,10,110,18,2,3,15,5,1,1,1,2,2,1,1
16018,2016-02-17,"05,10,13,27,33","08,11",5,10,13,27,33,8,11,88,28,4,1,19,3,1,1,2,1,2,2,0
16019,2016-02-20,"04,11,15,20,26","08,09",4,11,15,20,26,8,9,76,22,2,3,17,1,1,1,2,2,1,2,0
16020,2016-02-22,"01,16,22,29,30","02,09",1,16,22,29,30,2,9,98,29,2,3,11,7,1,1,1,2,2,1,1
16021,2016-02-24,"01,04,09,10,35","09,11",1,4,9,10,35,9,11,59,34,3,2,20,2,2,0,4,0,1,2,0
16022,2016-02-27,"04,18,21,30,35","02,11",4,18,21,30,35,2,11,108,31,2,3,13,9,1,1,1,2,2,1,1
16023,2016-02-29,"04,09,14,25,27","06,11",4,9,14,25,27,6,11,79,23,3,2,17,5,1,1,2,1,2,1,1
16024,2016-03-02,"01,02,11,15,18","04,08",1,2,11,15,18,4,8,47,17,3,2,12,4,0,2,3,2,0,1,1
16025,2016-03-05,"03,06,13,23,24","07,10",3,6,13,23,24,7,10,69,21,3,2,17,3,1,1,2,3,0,2,0
16026,2016-03-07,"02,06,29,30,34","01,07",2,6,29,30,34,1,7,101,32,1,4,8,6,2,0,2,0,3,1,1
16027,2016-03-09,"06,11,13,15,28","02,06",6,11,13,15,28,2,6,73,22,3,2,8,4,0,2,2,2,1,0,2
16028,2016-03-12,"13,18,20,23,31","03,06",13,18,20,23,31,3,6,105,18,3,2,9,3,1,1,0,4,1,0,2
16029,2016-03-14,"20,26,27,29,32","05,12",20,26,27,29,32,5,12,134,12,2,3,17,7,1,1,0,1,4,1,1
16030,2016-03-16,"10,19,21,29,33","04,06",10,19,21,29,33,4,6,112,23,4,1,10,2,0,2,1,2,2,0,2
16031,2016-03-19,"03,14,24,27,29","04,11",3,14,24,27,29,4,11,97,26,3,2,15,7,1,1,1,2,2,1,1
16032,2016-03-21,"05,09,14,20,33","05,12",5,9,14,20,33,5,12,81,28,3,2,17,7,1,1,2,2,1,1,1
16033,2016-03-23,"03,14,15,31,35","09,10",3,14,15,31,35,9,10,98,32,4,1,19,1,1,1,1,2,2,2,0
16034,2016-03-26,"14,18,31,32,35","09,10",14,18,31,32,35,9,10,130,21,2,3,19,1,1,1,0,2,3,2,0
16035,2016-03-28,"17,22,24,25,29","09,12",17,22,24,25,29,9,12,117,12,3,2,21,3,1,1,0,3,2,2,0
16036,2016-03-30,"07,15,26,30,31","03,06",7,15,26,30,31,3,6,109,24,3,2,9,3,1,1,1,1,3,0,2
16037,2016-04-02,"03,05,13,24,34","03,05",3,5,13,24,34,3,5,79,31,3,2,8,2,2,0,2,2,1,0,2
16038,2016-04-04,"03,07,09,15,33","05,12",3,7,9,15,33,5,12,67,30,5,0,17,7,1,1,3,1,1,1,1
16039,2016-04-06,"01,08,16,22,28","04,05",1,8,16,22,28,4,5,75,27,1,4,9,1,1,1,2,2,1,0,2
16040,2016-04-09,"20,22,29,30,35","01,06",20,22,29,30,35,1,6,136,15,2,3,7,5,1,1,0,2,3,0,2
16041,2016-04-11,"12,23,24,27,34","03,06",12,23,24,27,34,3,6,120,22,2,3,9,3,1,1,1,2,2,0,2
16042,2016-04-13,"02,06,08,19,24","01,06",2,6,8,19,24,1,6,59,22,1,4,7,5,1,1,3,2,0,0,2
16043,2016-04-16,"01,09,16,33,34","09,12",1,9,16,33,34,9,12,93,33,3,2,21,3,1,1,2,1,2,2,0
16044,2016-04-18,"01,06,10,20,31","05,11",1,6,10,20,31,5,11,68,30,2,3,16,6,2,0,3,1,1,1,1
16045,2016-04-20,"07,11,25,30,33","02,08",7,11,25,30,33,2,8,106,26,4,1,10,6,0,2,2,0,3,1,1
16046,2016-04-23,"03,19,22,32,34","08,12",3,19,22,32,34,8,12,110,31,2,3,20,4,0,2,1,2,2,2,0
16047,2016-04-25,"02,03,23,29,32","05,09",2,3,23,29,32,5,9,89,30,3,2,14,4,2,0,2,1,2,1,1
16048,2016-04-27,"04,12,17,25,27","04,10",4,12,17,25,27,4,10,85,23,3,2,14,6,0,2,2,1,2,1,1
16049,2016-04-30,"03,04,05,27,33","04,09",3,4,5,27,33,4,9,72,30,4,1,13,5,1,1,3,0,2,1,1
16050,2016-05-02,"07,17,21,29,35","04,05",7,17,21,29,35,4,5,109,28,5,0,9,1,1,1,1,2,2,0,2
16051,2016-05-04,"16,21,23,24,32","07,08",16,21,23,24,32,7,8,116,16,2,3,15,1,1,1,0,4,1,2,0
16052,2016-05-07,"08,14,19,20,33","10,11",8,14,19,20,33,10,11,94,25,2,3,21,1,1,1,1,3,1,2,0
16053,2016-05-09,"04,13,15,30,35","03,05",4,13,15,30,35,3,5,97,31,3,2,8,2,2,0,1,2,2,0,2
16054,2016-05-11,"02,05,09,21,30","06,07",2,5,9,21,30,6,7,67,28,3,2,13,1,1,1,3,1,1,1,1
16055,2016-05-14,"06,21,27,30,34","04,09",6,21,27,30,34,4,9,118,28,2,3,13,5,1,1,1,1,3,1,1
16056,2016-05-16,"10,12,14,31,35","04,05",10,12,14,31,35,4,5,102,25,2,3,9,1,1,1,2,1,2,0,2
16057,2016-05-18,"08,17,19,23,30","03,08",8,17,19,23,30,3,8,97,22,3,2,11,5,1,1,1,3,1,1,1
16058,2016-05-21,"02,15,17,23,28","05,09",2,15,17,23,28,5,9,85,26,3,2,14,4,2,0,1,3,1,1,1
16059,2016-05-23,"02,10,27,28,33","05,07",2,10,27,28,33,5,7,100,31,2,3,12,2,2,0,2,0,3,1,1
16060,2016-05-25,"02,06,22,27,34","08,11",2,6,22,27,34,8,11,91,32,1,4,19,3,1,1,2,1,2,2,0
16061,2016-05-28,"09,15,17,21,23","07,12",9,15,17,21,23,7,12,85,14,5,0,19,5,1,1,1,4,0,2,0
16062,2016-05-30,"02,10,14,15,35","01,09",2,10,14,15,35,1,9,76,33,2,3,10,8,2,0,2,2,1,1,1
16063,2016-06-01,"08,12,22,27,35","05,09",8,12,22,27,35,5,9,104,27,2,3,14,4,2,0,2,1,2,1,1
16064,2016-06-04,"01,02,10,18,35","05,11",1,2,10,18,35,5,11,66,34,2,3,16,6,2,0,3,1,1,1,1
16065,2016-06-06,"01,09,18,22,24","11,12",1,9,18,22,24,11,12,74,23,2,3,23,1,1,1,2,3,0,2,0
16066,2016-06-08,"10,28,29,31,33","05,11",10,28,29,31,33,5,11,131,23,3,2,16,6,2,0,1,0,4,1,1
16067,2016-06-11,"02,08,11,13,19","02,08",2,8,11,13,19,2,8,53,17,3,2,10,6,0,2,3,2,0,1,1
16068,2016-06-13,"05,07,22,26,34","07,12",5,7,22,26,34,7,12,94,29,2,3,19,5,1,1,2,1,2,2,0
16069,2016-06-15,"14,17,19,23,30","02,09",14,17,19,23,30,2,9,103,16,3,2,11,7,1,1,0,4,1,1,1
16070,2016-06-18,"02,09,13,19,23","05,07",2,9,13,19,23,5,7,66,21,4,1,12,2,2,0,2,3,0,1,1
16071,2016-06-20,"08,15,19,20,33","07,12",8,15,19,20,33,7,12,95,25,3,2,19,5,1,1,1,3,1,2,0
16072,2016-06-22,"16,20,24,26,31","04,09",16,20,24,26,31,4,9,117,15,1,4,13,5,1,1,0,3,2,1,1
16073,2016-06-25,"07,14,17,24,27","08,10",7,14,17,24,27,8,10,89,20,3,2,18,2,0,2,1,3,1,2,0
16074,2016-06-27,"01,05,07,11,14","03,08",1,5,7,11,14,3,8,38,13,4,1,11,5,1,1,4,1,0,1,1
16075,2016-06-29,"03,07,17,22,31","08,12",3,7,17,22,31,8,12,80,28,4,1,20,4,0,2,2,2,1,2,0
16076,2016-07-02,"03,08,10,17,31","05,06",3,8,10,17,31,5,6,69,28,3,2,11,1,1,1,3,1,1,0,2
16077,2016-07-04,"09,11,14,16,35","02,05",9,11,14,16,35,2,5,85,26,3,2,7,3,1,1,2,2,1,0,2
16078,2016-07-06,"07,18,29,31,35","05,11",7,18,29,31,35,5,11,120,28,4,1,16,6,2,0,1,1,3,1,1
16079,2016-07-09,"07,14,15,20,27","05,10",7,14,15,20,27,5,10,83,20,3,2,15,5,1,1,1,3,1,1,1
16080,2016-07-11,"15,20,29,30,33","07,12",15,20,29,30,33,7,12,127,18,3,2,19,5,1,1,0,2,3,2,0
16081,2016-07-13,"06,07,18,21,33","03,08",6,7,18,21,33,3,8,85,27,3,2,11,5,1,1,2,2,1,1,1
16082,2016-07-16,"03,08,23,28,29","02,07",3,8,23,28,29,2,7,91,26,3,2,9,5,1,1,2,1,2,1,1
16083,2016-07-18,"01,05,09,33,35","01,05",1,5,9,33,35,1,5,83,34,5,0,6,4,2,0,3,0,2,0,2
16084,2016-07-20,"08,12,15,26,35","01,08",8,12,15,26,35,1,8,96,27,2,3,9,7,1,1,2,1,2,1,1
16085,2016-07-23,"14,15,27,31,32","01,07",14,15,27,31,32,1,7,119,18,3,2,8,6,2,0,0,2,3,1,1
16086,2016-07-25,"03,05,22,25,30","07,09",3,5,22,25,30,7,9,85,27,3,2,16,2,2,0,2,1,2,2,0
16087,2016-07-27,"03,16,17,23,25","07,09",3,16,17,23,25,7,9,84,22,4,1,16,2,2,0,1,3,1,2,0
16088,2016-07-30,"04,06,17,21,30","06,11",4,6,17,21,30,6,11,78,26,2,3,17,5,1,1,2,2,1,1,1
16089,2016-08-01,"07,14,17,28,34","07,10",7,14,17,28,34,7,10,100,27,2,3,17,3,1,1,1,2,2,2,0
16090,2016-08-03,"04,06,08,28,32","07,12",4,6,8,28,32,7,12,78,28,0,5,19,5,1,1,3,0,2,2,0
16091,2016-08-06,"08,13,17,21,22","02,08",8,13,17,21,22,2,8,81,14,3,2,10,6,0,2,1,4,0,1,1
16092,2016-08-08,"02,13,31,33,34","07,11",2,13,31,33,34,7,11,113,32,3,2,18,4,2,0,1,1,3,2,0
16093,2016-08-10,"01,08,14,30,35","06,07",1,8,14,30,35,6,7,88,34,2,3,13,1,1,1,2,1,2,1,1
16094,2016-08-13,"01,14,16,17,18","05,07",1,14,16,17,18,5,7,66,17,2,3,12,2,2,0,1,4,0,1,1
16095,2016-08-15,"08,12,18,19,21","03,06",8,12,18,19,21,3,6,78,13,2,3,9,3,1,1,2,3,0,0,2
16096,2016-08-17,"01,06,08,12,21","05,10",1,6,8,12,21,5,10,48,20,2,3,15,5,1,1,4,1,0,1,1
16097,2016-08-20,"06,08,18,31,33","10,12",6,8,18,31,33,10,12,96,27,2,3,22,2,0,2,2,1,2,2,0
16098,2016-08-22,"08,09,11,20,29","04,05",8,9,11,20,29,4,5,77,21,3,2,9,1,1,1,3,1,1,0,2
16099,2016-08-24,"03,04,12,14,27","01,05",3,4,12,14,27,1,5,60,24,2,3,6,4,2,0,3,1,1,0,2
16100,2016-08-27,"08,12,19,26,30","02,12",8,12,19,26,30,2,12,95,22,1,4,14,10,0,2,2,1,2,1,1
16101,2016-08-29,"04,06,28,33,35","07,12",4,6,28,33,35,7,12,106,31,2,3,19,5,1,1,2,0,3,2,0
16102,2016-08-31,"03,05,06,34,35","03,12",3,5,6,34,35,3,12,83,32,3,2,15,9,1,1,3,0,2,1,1
16103,2016-09-03,"05,14,20,23,29","03,11",5,14,20,23,29,3,11,91,24,3,2,14,8,2,0,1,3,1,1,1
16104,2016-09-05,"01,20,22,23,30","06,07",1,20,22,23,30,6,7,96,29,2,3,13,1,1,1,1,3,1,1,1
16105,2016-09-07,"08,11,31,34,35","01,02",8,11,31,34,35,1,2,119,27,3,2,3,1,1,1,2,0,3,0,2
16106,2016-09-10,"03,21,30,33,35","01,04",3,21,30,33,35,1,4,122,32,4,1,5,3,1,1,1,1,3,0,2
16107,2016-09-12,"02,06,19,24,26","04,06",2,6,19,24,26,4,6,77,24,1,4,10,2,0,2,2,2,1,0,2
16108,2016-09-14,"10,17,22,23,25","07,09",10,17,22,23,25,7,9,97,15,3,2,16,2,2,0,1,3,1,2,0
16109,2016-09-17,"03,25,28,31,34","11,12",3,25,28,31,34,11,12,121,31,3,2,23,1,1,1,1,0,4,2,0
16110,2016-09-19,"07,20,21,23,30","07,10",7,20,21,23,30,7,10,101,23,3,2,17,3,1,1,1,3,1,2,0
16111,2016-09-21,"04,09,22,26,27","02,12",4,9,22,26,27,2,12,88,23,2,3,14,10,0,2,2,1,2,1,1
16112,2016-09-24,"07,22,23,31,32","04,05",7,22,23,31,32,4,5,115,25,3,2,9,1,1,1,1,2,2,0,2
16113,2016-09-26,"10,11,17,30,34","03,12",10,11,17,30,34,3,12,102,24,2,3,15,9,1,1,2,1,2,1,1
16114,2016-09-28,"16,17,20,32,33","03,07",16,17,20,32,33,3,7,118,17,2,3,10,4,2,0,0,3,2,1,1
16115,2016-10-01,"01,04,15,31,34","02,11",1,4,15,31,34,2,11,85,33,3,2,13,9,1,1,2,1,2,1,1
16116,2016-10-03,"04,06,08,19,34","10,12",4,6,8,19,34,10,12,71,30,1,4,22,2,0,2,3,1,1,2,0
16117,2016-10-05,"03,09,14,16,23","02,09",3,9,14,16,23,2,9,65,20,3,2,11,7,1,1,2,3,0,1,1
16118,2016-10-08,"12,15,18,24,29","03,11",12,15,18,24,29,3,11,98,17,2,3,14,8,2,0,1,3,1,1,1
16119,2016-10-10,"02,03,09,21,22","05,10",2,3,9,21,22,5,10,57,20,3,2,15,5,1,1,3,2,0,1,1
16120,2016-10-12,"03,10,20,32,34","04,07",3,10,20,32,34,4,7,99,31,1,4,11,3,1,1,2,1,2,1,1
16121,2016-10-15,"04,05,08,15,20","01,06",4,5,8,15,20,1,6,52,16,2,3,7,5,1,1,3,2,0,0,2
16122,2016-10-17,"01,03,12,14,29","02,06",1,3,12,14,29,2,6,59,28,3,2,8,4,0,2,3,1,1,0,2
16123,2016-10-19,"04,05,13,20,32","01,10",4,5,13,20,32,1,10,74,28,2,3,11,9,1,1,2,2,1,1,1
16124,2016-10-22,"04,13,24,26,29","08,11",4,13,24,26,29,8,11,96,25,2,3,19,3,1,1,1,2,2,2,0
16125,2016-10-24,"06,07,08,28,30","01,02",6,7,8,28,30,1,2,79,24,1,4,3,1,1,1,3,0,2,0,2
16126,2016-10-26,"11,13,16,19,24","06,08",11,13,16,19,24,6,8,83,13,3,2,14,2,0,2,1,4,0,1,1
16127,2016-10-29,"01,05,15,24,26","09,10",1,5,15,24,26,9,10,71,25,3,2,19,1,1,1,2,2,1,2,0
16128,2016-10-31,"17,20,22,30,33","07,08",17,20,22,30,33,7,8,122,16,2,3,15,1,1,1,0,3,2,2,0
16129,2016-11-02,"07,08,19,30,35","08,09",7,8,19,30,35,8,9,99,28,3,2,17,1,1,1,2,1,2,2,0
16130,2016-11-05,"11,23,32,33,34","01,12",11,23,32,33,34,1,12,133,23,3,2,13,11,1,1,1,1,3,1,1
16131,2016-11-07,"06,13,25,28,30","02,07",6,13,25,28,30,2,7,102,24,2,3,9,5,1,1,1,1,3,1,1
16132,2016-11-09,"04,18,19,22,35","01,02",4,18,19,22,35,1,2,98,31,2,3,3,1,1,1,1,3,1,0,2
16133,2016-11-12,"01,04,05,23,28","05,09",1,4,5,23,28,5,9,61,27,3,2,14,4,2,0,3,1,1,1,1
16134,2016-11-14,"01,03,31,32,34","02,07",1,3,31,32,34,2,7,101,33,3,2,9,5,1,1,2,0,3,1,1
16135,2016-11-16,"01,10,12,18,35","01,12",1,10,12,18,35,1,12,76,34,2,3,13,11,1,1,3,1,1,1,1
16136,2016-11-19,"05,06,07,19,23","04,11",5,6,7,19,23,4,11,60,18,4,1,15,7,1,1,3,2,0,1,1
16137,2016-11-21,"07,20,23,29,34","02,10",7,20,23,29,34,2,10,113,27,3,2,12,8,0,2,1,2,2,1,1
16138,2016-11-23,"12,13,16,29,35","05,11",12,13,16,29,35,5,11,105,23,3,2,16,6,2,0,1,2,2,1,1
16139,2016-11-26,"13,21,30,31,35","01,08",13,21,30,31,35,1,8,130,22,4,1,9,7,1,1,0,2,3,1,1
16140,2016-11-28,"12,16,23,29,34","04,11",12,16,23,29,34,4,11,114,22,2,3,15,7,1,1,1,2,2,1,1
16141,2016-11-30,"02,06,07,19,28","11,12",2,6,7,19,28,11,12,62,26,2,3,23,1,1,1,3,1,1,2,0
16142,2016-12-03,"01,06,17,23,26","06,12",1,6,17,23,26,6,12,73,25,3,2,18,6,0,2,2,2,1,1,1
16143,2016-12-05,"04,06,22,27,31","06,07",4,6,22,27,31,6,7,90,27,2,3,13,1,1,1,2,1,2,1,1
16144,2016-12-07,"04,05,13,22,31","05,10",4,5,13,22,31,5,10,75,27,3,2,15,5,1,1,2,2,1,1,1
16145,2016-12-10,"01,09,11,17,28","03,08",1,9,11,17,28,3,8,66,27,4,1,11,5,1,1,3,1,1,1,1
16146,2016-12-12,"21,22,25,29,34","01,11",21,22,25,29,34,1,11,131,13,3,2,12,10,2,0,0,2,3,1,1
16147,2016-12-14,"07,19,20,28,30","04,12",7,19,20,28,30,4,12,104,23,2,3,16,8,0,2,1,2,2,1,1
16148,2016-12-17,"05,14,15,23,25","06,08",5,14,15,23,25,6,8,82,20,4,1,14,2,0,2,1,3,1,1,1
16149,2016-12-19,"01,02,03,12,33","04,09",1,2,3,12,33,4,9,51,32,3,2,13,5,1,1,4,0,1,1,1
16150,2016-12-21,"01,10,18,24,29","07,10",1,10,18,24,29,7,10,82,28,2,3,17,3,1,1,2,2,1,2,0
16151,2016-12-24,"04,07,11,14,21","05,12",4,7,11,14,21,5,12,57,17,3,2,17,7,1,1,3,2,0,1,1
16152,2016-12-26,"08,17,22,24,30","05,11",8,17,22,24,30,5,11,101,22,1,4,16,6,2,0,1,3,1,1,1
16153,2016-12-28,"13,18,25,29,35","03,11",13,18,25,29,35,3,11,120,22,4,1,14,8,2,0,0,2,3,1,1
16154,2016-12-31,"06,16,17,21,29","04,06",6,16,17,21,29,4,6,89,23,3,2,10,2,0,2,1,3,1,0,2
17001,2017-01-02,"07,09,20,31,33","08,10",7,9,20,31,33,8,10,100,26,4,1,18,2,0,2,2,1,2,2,0
17002,2017-01-04,"07,12,14,31,34","09,11",7,12,14,31,34,9,11,98,27,2,3,20,2,2,0,2,1,2,2,0
17003,2017-01-07,"03,05,06,13,22","09,12",3,5,6,13,22,9,12,49,19,3,2,21,3,1,1,3,2,0,2,0
17004,2017-01-09,"05,08,11,28,31","06,07",5,8,11,28,31,6,7,83,26,3,2,13,1,1,1,3,0,2,1,1
17005,2017-01-11,"05,09,20,26,35","02,11",5,9,20,26,35,2,11,95,30,3,2,13,9,1,1,2,1,2,1,1
17006,2017-01-14,"04,06,23,32,33","05,06",4,6,23,32,33,5,6,98,29,2,3,11,1,1,1,2,1,2,0,2
17007,2017-01-16,"08,11,17,25,27","02,04",8,11,17,25,27,2,4,88,19,4,1,6,2,0,2,2,1,2,0,2
17008,2017-01-18,"03,04,09,25,32","02,04",3,4,9,25,32,2,4,73,29,3,2,6,2,0,2,3,0,2,0,2
17009,2017-01-21,"05,06,08,12,22","03,04",5,6,8,12,22,3,4,53,17,1,4,7,1,1,1,4,1,0,0,2
17010,2017-01-23,"04,10,13,18,35","01,02",4,10,13,18,35,1,2,80,31,2,3,3,1,1,1,2,2,1,0,2
17011,2017-01-25,"05,15,21,29,34","06,09",5,15,21,29,34,6,9,104,29,4,1,15,3,1,1,1,2,2,1,1
17012,2017-02-04,"04,05,24,26,35","07,12",4,5,24,26,35,7,12,94,31,2,3,19,5,1,1,2,1,2,2,0
17013,2017-02-06,"05,12,17,30,34","11,12",5,12,17,30,34,11,12,98,29,2,3,23,1,1,1,2,1,2,2,0
17014,2017-02-08,"04,08,15,24,25","02,05",4,8,15,24,25,2,5,76,21,2,3,7,3,1,1,2,2,1,0,2
17015,2017-02-11,"01,07,19,27,34","01,02",1,7,19,27,34,1,2,88,33,4,1,3,1,1,1,2,1,2,0,2
17016,2017-02-13,"03,13,28,30,33","09,10",3,13,28,30,33,9,10,107,30,3,2,19,1,1,1,1,1,3,2,0
17017,2017-02-15,"04,19,24,26,29","04,06",4,19,24,26,29,4,6,102,25,2,3,10,2,0,2,1,2,2,0,2
17018,2017-02-18,"06,07,10,17,23","01,09",6,7,10,17,23,1,9,63,17,3,2,10,8,2,0,3,2,0,1,1
17019,2017-02-20,"02,06,14,23,25","02,10",2,6,14,23,25,2,10,70,23,2,3,12,8,0,2,2,2,1,1,1
17020,2017-02-22,"16,21,24,27,28","04,07",16,21,24,27,28,4,7,116,12,2,3,11,3,1,1,0,3,2,1,1
17021,2017-02-25,"01,15,17,20,26","06,08",1,15,17,20,26,6,8,79,25,3,2,14,2,0,2,1,3,1,1,1
17022,2017-02-27,"02,03,09,17,24","06,12",2,3,9,17,24,6,12,55,22,3,2,18,6,0,2,3,2,0,1,1
17023,2017-03-01,"05,08,12,24,34","07,10",5,8,12,24,34,7,10,83,29,1,4,17,3,1,1,3,1,1,2,0
17024,2017-03-04,"21,23,29,32,35","11,12",21,23,29,32,35,11,12,140,14,4,1,23,1,1,1,0,2,3,2,0
17025,2017-03-06,"10,16,19,20,34","04,05",10,16,19,20,34,4,5,99,24,1,4,9,1,1,1,1,3,1,0,2
17026,2017-03-08,"10,14,19,25,32","02,07",10,14,19,25,32,2,7,100,22,2,3,9,5,1,1,1,2,2,1,1
17027,2017-03-11,"08,17,25,33,34","03,11",8,17,25,33,34,3,11,117,26,3,2,14,8,2,0,1,1,3,1,1
17028,2017-03-13,"06,18,22,23,33","09,11",6,18,22,23,33,9,11,102,27,2,3,20,2,2,0,1,3,1,2,0
17029,2017-03-15,"01,06,14,17,29","01,11",1,6,14,17,29,1,11,67,28,3,2,12,10,2,0,2,2,1,1,1
17030,2017-03-18,"21,22,24,29,34","05,06",21,22,24,29,34,5,6,130,13,2,3,11,1,1,1,0,3,2,0,2
17031,2017-03-20,"02,16,17,30,32","02,09",2,16,17,30,32,2,9,97,30,1,4,11,7,1,1,1,2,2,1,1
17032,2017-03-22,"02,13,14,18,29","03,09",2,13,14,18,29,3,9,76,27,2,3,12,6,2,0,1,3,1,1,1
17033,2017-03-25,"15,22,23,25,34","05,11",15,22,23,25,34,5,11,119,19,3,2,16,6,2,0,0,3,2,1,1
17034,2017-03-27,"06,12,21,26,29","02,11",6,12,21,26,29,2,11,94,23,2,3,13,9,1,1,2,1,2,1,1
17035,2017-03-29,"14,17,22,30,33","07,12",14,17,22,30,33,7,12,116,19,2,3,19,5,1,1,0,3,2,2,0
17036,2017-04-01,"01,04,09,18,33","02,05",1,4,9,18,33,2,5,65,32,3,2,7,3,1,1,3,1,1,0,2
17037,2017-04-03,"13,15,16,32,34","06,11",13,15,16,32,34,6,11,110,21,2,3,17,5,1,1,0,3,2,1,1
17038,2017-04-05,"04,05,13,18,27","03,09",4,5,13,18,27,3,9,67,23,3,2,12,6,2,0,2,2,1,1,1
17039,2017-04-08,"05,06,14,17,26","03,08",5,6,14,17,26,3,8,68,21,2,3,11,5,1,1,2,2,1,1,1
17040,2017-04-10,"04,06,10,23,29","09,11",4,6,10,23,29,9,11,72,25,2,3,20,2,2,0,3,1,1,2,0
17041,2017-04-12,"02,04,06,25,31","05,09",2,4,6,25,31,5,9,68,29,2,3,14,4,2,0,3,0,2,1,1
17042,2017-04-15,"02,17,31,33,34","01,07",2,17,31,33,34,1,7,117,32,3,2,8,6,2,0,1,1,3,1,1
17043,2017-04-17,"06,13,22,25,35","09,12",6,13,22,25,35,9,12,101,29,3,2,21,3,1,1,1,2,2,2,0
17044,2017-04-19,"11,16,17,18,25","02,09",11,16,17,18,25,2,9,87,14,3,2,11,7,1,1,1,3,1,1,1
17045,2017-04-22,"01,08,11,21,35","09,12",1,8,11,21,35,9,12,76,34,4,1,21,3,1,1,3,1,1,2,0
17046,2017-04-24,"04,17,20,23,30","02,03",4,17,20,23,30,2,3,94,26,2,3,5,1,1,1,1,3,1,0,2
17047,2017-04-26,"15,19,32,33,34","09,12",15,19,32,33,34,9,12,133,19,3,2,21,3,1,1,0,2,3,2,0
17048,2017-04-29,"07,09,13,15,19","03,10",7,9,13,15,19,3,10,63,12,5,0,13,7,1,1,2,3,0,1,1
17049,2017-05-01,"09,12,14,22,31","05,08",9,12,14,22,31,5,8,88,22,2,3,13,3,1,1,2,2,1,1,1
17050,2017-05-03,"12,14,17,20,28","02,06",12,14,17,20,28,2,6,91,16,1,4,8,4,0,2,1,3,1,0,2
17051,2017-05-06,"14,17,18,22,29","10,11",14,17,18,22,29,10,11,100,15,2,3,21,1,1,1,0,4,1,2,0
17052,2017-05-08,"03,19,24,28,33","04,12",3,19,24,28,33,4,12,107,30,3,2,16,8,0,2,1,2,2,1,1
17053,2017-05-10,"06,19,20,22,26","01,11",6,19,20,22,26,1,11,93,20,1,4,12,10,2,0,1,3,1,1,1
17054,2017-05-13,"16,29,30,32,33","04,05",16,29,30,32,33,4,5,140,17,2,3,9,1,1,1,0,1,4,0,2
17055,2017-05-15,"19,20,22,30,33","03,09",19,20,22,30,33,3,9,124,14,2,3,12,6,2,0,0,3,2,1,1
17056,2017-05-17,"01,04,24,27,32","03,10",1,4,24,27,32,3,10,88,31,2,3,13,7,1,1,2,1,2,1,1
17057,2017-05-20,"12,16,19,23,24","02,05",12,16,19,23,24,2,5,94,12,2,3,7,3,1,1,1,4,0,0,2
17058,2017-05-22,"14,18,20,21,28","03,06",14,18,20,21,28,3,6,101,14,1,4,9,3,1,1,0,4,1,0,2
17059,2017-05-24,"08,11,13,15,17","03,10",8,11,13,15,17,3,10,64,9,4,1,13,7,1,1,2,3,0,1,1
17060,2017-05-27,"09,15,20,26,31","05,12",9,15,20,26,31,5,12,101,22,3,2,17,7,1,1,1,2,2,1,1
17061,2017-05-29,"10,19,23,25,30","02,04",10,19,23,25,30,2,4,107,20,3,2,6,2,0,2,1,2,2,0,2
17062,2017-05-31,"01,04,06,08,28","08,12",1,4,6,8,28,8,12,47,27,1,4,20,4,0,2,4,0,1,2,0
17063,2017-06-03,"18,21,22,24,29","05,11",18,21,22,24,29,5,11,114,11,2,3,16,6,2,0,0,4,1,1,1
17064,2017-06-05,"01,08,20,27,30","03,04",1,8,20,27,30,3,4,86,29,2,3,7,1,1,1,2,1,2,0,2
17065,2017-06-07,"05,11,12,19,28","05,12",5,11,12,19,28,5,12,75,23,3,2,17,7,1,1,3,1,1,1,1
17066,2017-06-10,"11,15,23,26,30","02,11",11,15,23,26,30,2,11,105,19,3,2,13,9,1,1,1,2,2,1,1
17067,2017-06-12,"10,17,18,32,35","10,11",10,17,18,32,35,10,11,112,25,2,3,21,1,1,1,1,2,2,2,0
17068,2017-06-14,"07,08,19,24,27","06,07",7,8,19,24,27,6,7,85,20,3,2,13,1,1,1,2,2,1,1,1
17069,2017-06-17,"10,16,20,23,32","08,11",10,16,20,23,32,8,11,101,22,1,4,19,3,1,1,1,3,1,2,0
17070,2017-06-19,"06,16,18,26,30","02,03",6,16,18,26,30,2,3,96,24,0,5,5,1,1,1,1,2,2,0,2
17071,2017-06-21,"01,04,11,14,33","05,07",1,4,11,14,33,5,7,63,32,3,2,12,2,2,0,3,1,1,1,1
17072,2017-06-24,"01,03,29,32,34","02,05",1,3,29,32,34,2,5,99,33,3,2,7,3,1,1,2,0,3,0,2
17073,2017-06-26,"07,18,28,31,33","01,02",7,18,28,31,33,1,2,117,26,3,2,3,1,1,1,1,1,3,0,2
17074,2017-06-28,"08,10,11,13,17","08,11",8,10,11,13,17,8,11,59,9,3,2,19,3,1,1,3,2,0,2,0
17075,2017-07-01,"05,11,16,18,35","01,06",5,11,16,18,35,1,6,85,30,3,2,7,5,1,1,2,2,1,0,2
17076,2017-07-03,"02,07,25,30,35","07,12",2,7,25,30,35,7,12,99,33,3,2,19,5,1,1,2,0,3,2,0
17077,2017-07-05,"01,03,04,25,31","06,09",1,3,4,25,31,6,9,64,30,4,1,15,3,1,1,3,0,2,1,1
17078,2017-07-08,"04,05,27,31,34","03,06",4,5,27,31,34,3,6,101,30,3,2,9,3,1,1,2,0,3,0,2
17079,2017-07-10,"01,17,19,32,33","02,11",1,17,19,32,33,2,11,102,32,4,1,13,9,1,1,1,2,2,1,1
17080,2017-07-12,"08,10,21,30,31","02,05",8,10,21,30,31,2,5,100,23,2,3,7,3,1,1,2,1,2,0,2
17081,2017-07-15,"02,12,15,20,34","01,06",2,12,15,20,34,1,6,83,32,1,4,7,5,1,1,2,2,1,0,2
17082,2017-07-17,"05,13,20,21,25","08,09",5,13,20,21,25,8,9,84,20,4,1,17,1,1,1,1,3,1,2,0
17083,2017-07-19,"02,05,14,22,34","03,09",2,5,14,22,34,3,9,77,32,1,4,12,6,2,0,2,2,1,1,1
17084,2017-07-22,"06,11,14,21,31","09,12",6,11,14,21,31,9,12,83,25,3,2,21,3,1,1,2,2,1,2,0
17085,2017-07-24,"09,13,14,25,30","02,05",9,13,14,25,30,2,5,91,21,3,2,7,3,1,1,1,2,2,0,2
17086,2017-07-26,"12,15,18,22,31","01,08",12,15,18,22,31,1,8,98,19,2,3,9,7,1,1,1,3,1,1,1
17087,2017-07-29,"03,14,21,29,35","02,06",3,14,21,29,35,2,6,102,32,4,1,8,4,0,2,1,2,2,0,2
17088,2017-07-31,"05,28,31,34,35","08,09",5,28,31,34,35,8,9,133,30,3,2,17,1,1,1,1,0,4,2,0
17089,2017-08-02,"03,05,06,15,18","03,10",3,5,6,15,18,3,10,47,15,3,2,13,7,1,1,3,2,0,1,1
17090,2017-08-05,"03,06,15,22,35","09,11",3,6,15,22,35,9,11,81,32,3,2,20,2,2,0,2,2,1,2,0
17091,2017-08-07,"01,05,07,16,19","03,12",1,5,7,16,19,3,12,48,18,4,1,15,9,1,1,3,2,0,1,1
17092,2017-08-09,"03,07,09,17,34","04,05",3,7,9,17,34,4,5,70,31,4,1,9,1,1,1,3,1,1,0,2
17093,2017-08-12,"05,06,17,21,29","02,04",5,6,17,21,29,2,4,78,24,4,1,6,2,0,2,2,2,1,0,2
17094,2017-08-14,"03,05,08,29,33","04,08",3,5,8,29,33,4,8,78,30,4,1,12,4,0,2,3,0,2,1,1
17095,2017-08-16,"15,32,33,34,35","03,12",15,32,33,34,35,3,12,149,20,3,2,15,9,1,1,0,1,4,1,1
17096,2017-08-19,"03,07,09,17,28","04,12",3,7,9,17,28,4,12,64,25,4,1,16,8,0,2,3,1,1,1,1
17097,2017-08-21,"07,14,19,22,34","07,12",7,14,19,22,34,7,12,96,27,2,3,19,5,1,1,1,3,1,2,0
17098,2017-08-23,"06,09,17,30,35","10,11",6,9,17,30,35,10,11,97,29,3,2,21,1,1,1,2,1,2,2,0
17099,2017-08-26,"08,09,17,18,24","03,07",8,9,17,18,24,3,7,76,16,2,3,10,4,2,0,2,3,0,1,1
17100,2017-08-28,"02,05,18,19,31","01,09",2,5,18,19,31,1,9,75,29,3,2,10,8,2,0,2,2,1,1,1
17101,2017-08-30,"05,15,21,25,29","05,08",5,15,21,25,29,5,8,95,24,5,0,13,3,1,1,1,2,2,1,1
17102,2017-09-02,"01,12,23,24,29","08,12",1,12,23,24,29,8,12,89,28,3,2,20,4,0,2,2,2,1,2,0
17103,2017-09-04,"04,19,20,24,29","03,04",4,19,20,24,29,3,4,96,25,2,3,7,1,1,1,1,3,1,0,2
17104,2017-09-06,"09,11,22,27,30","09,11",9,11,22,27,30,9,11,99,21,3,2,20,2,2,0,2,1,2,2,0
17105,2017-09-09,"04,15,22,24,32","02,09",4,15,22,24,32,2,9,97,28,1,4,11,7,1,1,1,3,1,1,1
17106,2017-09-11,"09,12,18,23,29","02,04",9,12,18,23,29,2,4,91,20,3,2,6,2,0,2,2,2,1,0,2
17107,2017-09-13,"04,10,19,25,27","06,12",4,10,19,25,27,6,12,85,23,3,2,18,6,0,2,2,1,2,1,1
17108,2017-09-16,"01,04,15,21,22","04,09",1,4,15,21,22,4,9,63,21,3,2,13,5,1,1,2,3,0,1,1
17109,2017-09-18,"06,09,19,26,34","05,07",6,9,19,26,34,5,7,94,28,2,3,12,2,2,0,2,1,2,1,1
17110,2017-09-20,"10,14,20,21,35","02,05",10,14,20,21,35,2,5,100,25,2,3,7,3,1,1,1,3,1,0,2
17111,2017-09-23,"02,14,17,26,34","08,12",2,14,17,26,34,8,12,93,32,1,4,20,4,0,2,1,2,2,2,0
17112,2017-09-25,"05,06,20,31,32","06,12",5,6,20,31,32,6,12,94,27,2,3,18,6,0,2,2,1,2,1,1
17113,2017-09-27,"05,08,17,18,23","04,12",5,8,17,18,23,4,12,71,18,3,2,16,8,0,2,2,3,0,1,1
17114,2017-09-30,"06,07,12,18,23","01,12",6,7,12,18,23,1,12,66,17,2,3,13,11,1,1,3,2,0,1,1
17115,2017-10-02,"14,19,20,25,31","06,08",14,19,20,25,31,6,8,109,17,3,2,14,2,0,2,0,3,2,1,1
17116,2017-10-04,"02,27,30,32,33","01,03",2,27,30,32,33,1,3,124,31,2,3,4,2,2,0,1,0,4,0,2
17117,2017-10-07,"05,07,09,24,32","08,10",5,7,9,24,32,8,10,77,27,3,2,18,2,0,2,3,1,1,2,0
17118,2017-10-09,"02,07,16,20,33","03,11",2,7,16,20,33,3,11,78,31,2,3,14,8,2,0,2,2,1,1,1
17119,2017-10-11,"05,07,13,29,35","03,08",5,7,13,29,35,3,8,89,30,5,0,11,5,1,1,2,1,2,1,1
17120,2017-10-14,"08,15,24,26,27","05,06",8,15,24,26,27,5,6,100,19,2,3,11,1,1,1,1,2,2,0,2
17121,2017-10-16,"01,06,12,26,31","01,07",1,6,12,26,31,1,7,76,30,2,3,8,6,2,0,3,0,2,1,1
17122,2017-10-18,"03,12,18,29,34","03,11",3,12,18,29,34,3,11,96,31,2,3,14,8,2,0,2,1,2,1,1
17123,2017-10-21,"03,15,23,26,32","01,12",3,15,23,26,32,1,12,99,29,3,2,13,11,1,1,1,2,2,1,1
17124,2017-10-23,"03,29,30,32,35","03,08",3,29,30,32,35,3,8,129,32,3,2,11,5,1,1,1,0,4,1,1
17125,2017-10-25,"07,11,18,26,28","04,05",7,11,18,26,28,4,5,90,21,2,3,9,1,1,1,2,1,2,0,2
17126,2017-10-28,"03,04,13,24,33","01,11",3,4,13,24,33,1,11,77,30,3,2,12,10,2,0,2,2,1,1,1
17127,2017-10-30,"02,15,18,21,22","03,10",2,15,18,21,22,3,10,78,20,2,3,13,7,1,1,1,4,0,1,1
17128,2017-11-01,"09,11,13,18,33","02,03",9,11,13,18,33,2,3,84,24,4,1,5,1,1,1,2,2,1,0,2
17129,2017-11-04,"05,17,20,32,33","04,09",5,17,20,32,33,4,9,107,28,3,2,13,5,1,1,1,2,2,1,1
17130,2017-11-06,"05,18,28,33,34","03,04",5,18,28,33,34,3,4,118,29,2,3,7,1,1,1,1,1,3,0,2
17131,2017-11-08,"03,05,08,19,34","01,12",3,5,8,19,34,1,12,69,31,3,2,13,11,1,1,3,1,1,1,1
17132,2017-11-11,"11,17,23,26,27","01,10",11,17,23,26,27,1,10,104,16,4,1,11,9,1,1,1,2,2,1,1
17133,2017-11-13,"15,17,19,32,33","01,03",15,17,19,32,33,1,3,116,18,4,1,4,2,2,0,0,3,2,0,2
17134,2017-11-15,"07,18,19,32,34","02,10",7,18,19,32,34,2,10,110,27,2,3,12,8,0,2,1,2,2,1,1
17135,2017-11-18,"01,12,15,19,22","02,04",1,12,15,19,22,2,4,69,21,3,2,6,2,0,2,2,3,0,0,2
17136,2017-11-20,"01,11,20,21,22","03,04",1,11,20,21,22,3,4,75,21,3,2,7,1,1,1,2,3,0,0,2
17137,2017-11-22,"01,20,22,28,29","05,07",1,20,22,28,29,5,7,100,28,2,3,12,2,2,0,1,2,2,1,1
17138,2017-11-25,"04,07,09,20,25","02,11",4,7,9,20,25,2,11,65,21,3,2,13,9,1,1,3,1,1,1,1
17139,2017-11-27,"02,06,19,25,32","09,12",2,6,19,25,32,9,12,84,30,2,3,21,3,1,1,2,1,2,2,0
17140,2017-11-29,"10,16,25,26,29","01,05",10,16,25,26,29,1,5,106,19,2,3,6,4,2,0,1,1,3,0,2
17141,2017-12-02,"02,08,21,22,29","03,05",2,8,21,22,29,3,5,82,27,2,3,8,2,2,0,2,2,1,0,2
17142,2017-12-04,"01,05,16,19,28","02,10",1,5,16,19,28,2,10,69,27,3,2,12,8,0,2,2,2,1,1,1
17143,2017-12-06,"06,09,24,29,32","02,07",6,9,24,29,32,2,7,100,26,2,3,9,5,1,1,2,1,2,1,1
17144,2017-12-09,"03,21,23,29,32","10,11",3,21,23,29,32,10,11,108,29,4,1,21,1,1,1,1,2,2,2,0
17145,2017-12-11,"04,07,17,18,19","03,10",4,7,17,18,19,3,10,65,15,3,2,13,7,1,1,2,3,0,1,1
17146,2017-12-13,"01,05,11,14,35","09,10",1,5,11,14,35,9,10,66,34,4,1,19,1,1,1,3,1,1,2,0
17147,2017-12-16,"05,16,17,25,34","01,11",5,16,17,25,34,1,11,97,29,3,2,12,10,2,0,1,2,2,1,1
17148,2017-12-18,"19,27,31,32,35","11,12",19,27,31,32,35,11,12,144,16,4,1,23,1,1,1,0,1,4,2,0
17149,2017-12-20,"10,18,19,25,26","04,12",10,18,19,25,26,4,12,98,16,2,3,16,8,0,2,1,2,2,1,1
17150,2017-12-23,"03,06,10,13,18","09,11",3,6,10,13,18,9,11,50,15,2,3,20,2,2,0,3,2,0,2,0
17151,2017-12-25,"05,06,23,28,32","04,05",5,6,23,28,32,4,5,94,27,2,3,9,1,1,1,2,1,2,0,2
17152,2017-12-27,"02,04,07,23,28","02,08",2,4,7,23,28,2,8,64,26,2,3,10,6,0,2,3,1,1,1,1
17153,2017-12-30,"01,09,24,26,34","09,12",1,9,24,26,34,9,12,94,33,2,3,21,3,1,1,2,1,2,2,0
18001,2018-01-01,"01,13,22,25,35","03,04",1,13,22,25,35,3,4,96,34,4,1,7,1,1,1,1,2,2,0,2
18002,2018-01-03,"12,20,23,27,34","01,06",12,20,23,27,34,1,6,116,22,2,3,7,5,1,1,1,2,2,0,2
18003,2018-01-06,"04,21,23,24,30","09,10",4,21,23,24,30,9,10,102,26,2,3,19,1,1,1,1,3,1,2,0
18004,2018-01-08,"04,09,22,28,30","01,10",4,9,22,28,30,1,10,93,26,1,4,11,9,1,1,2,1,2,1,1
18005,2018-01-10,"04,09,23,24,30","08,11",4,9,23,24,30,8,11,90,26,2,3,19,3,1,1,2,2,1,2,0
18006,2018-01-13,"19,20,30,32,33","03,05",19,20,30,32,33,3,5,134,14,2,3,8,2,2,0,0,2,3,0,2
18007,2018-01-15,"03,04,28,31,34","04,11",3,4,28,31,34,4,11,100,31,2,3,15,7,1,1,2,0,3,1,1
18008,2018-01-17,"09,15,17,20,22","10,11",9,15,17,20,22,10,11,83,13,3,2,21,1,1,1,1,4,0,2,0
18009,2018-01-20,"10,12,28,30,34","03,04",10,12,28,30,34,3,4,114,24,0,5,7,1,1,1,2,0,3,0,2
18010,2018-01-22,"24,25,26,28,29","04,12",24,25,26,28,29,4,12,132,5,2,3,16,8,0,2,0,1,4,1,1
18011,2018-01-24,"03,13,15,23,26","01,10",3,13,15,23,26,1,10,80,23,4,1,11,9,1,1,1,3,1,1,1
18012,2018-01-27,"03,22,24,29,34","07,11",3,22,24,29,34,7,11,112,31,2,3,18,4,2,0,1,2,2,2,0
18013,2018-01-29,"08,24,31,33,35","07,10",8,24,31,33,35,7,10,131,27,3,2,17,3,1,1,1,1,3,2,0
18014,2018-01-31,"14,16,18,24,31","01,08",14,16,18,24,31,1,8,103,17,1,4,9,7,1,1,0,4,1,1,1
18015,2018-02-03,"04,13,15,18,29","05,11",4,13,15,18,29,5,11,79,25,3,2,16,6,2,0,1,3,1,1,1
18016,2018-02-05,"01,02,12,13,23","09,12",1,2,12,13,23,9,12,51,22,3,2,21,3,1,1,3,2,0,2,0
18017,2018-02-07,"04,19,21,23,31","04,09",4,19,21,23,31,4,9,98,27,4,1,13,5,1,1,1,3,1,1,1
18018,2018-02-10,"06,08,13,24,28","06,12",6,8,13,24,28,6,12,79,22,1,4,18,6,0,2,2,2,1,1,1
18019,2018-02-12,"10,11,19,21,28","05,12",10,11,19,21,28,5,12,89,18,3,2,17,7,1,1,2,2,1,1,1
18020,2018-02-14,"01,10,13,14,21","09,12",1,10,13,14,21,9,12,59,20,3,2,21,3,1,1,2,3,0,2,0
18021,2018-02-24,"05,06,08,09,15","04,11",5,6,8,9,15,4,11,43,10,3,2,15,7,1,1,4,1,0,1,1
18022,2018-02-26,"02,10,19,33,35","05,06",2,10,19,33,35,5,6,99,33,3,2,11,1,1,1,2,1,2,0,2
18023,2018-02-28,"12,13,18,21,29","02,08",12,13,18,21,29,2,8,93,17,3,2,10,6,0,2,1,3,1,1,1
18024,2018-03-03,"02,16,24,30,32","04,07",2,16,24,30,32,4,7,104,30,0,5,11,3,1,1,1,2,2,1,1
18025,2018-03-05,"07,08,09,15,34","07,08",7,8,9,15,34,7,8,73,27,3,2,15,1,1,1,3,1,1,2,0
18026,2018-03-07,"01,02,03,04,30","03,05",1,2,3,4,30,3,5,40,29,2,3,8,2,2,0,4,0,1,0,2
18027,2018-03-10,"01,18,20,21,26","04,11",1,18,20,21,26,4,11,86,25,2,3,15,7,1,1,1,3,1,1,1
18028,2018-03-12,"04,19,25,30,35","04,07",4,19,25,30,35,4,7,113,31,3,2,11,3,1,1,1,1,3,1,1
18029,2018-03-14,"03,09,21,25,29","01,08",3,9,21,25,29,1,8,87,26,5,0,9,7,1,1,2,1,2,1,1
18030,2018-03-17,"05,18,21,28,32","09,11",5,18,21,28,32,9,11,104,27,2,3,20,2,2,0,1,2,2,2,0
18031,2018-03-19,"03,08,13,17,23","05,11",3,8,13,17,23,5,11,64,20,4,1,16,6,2,0,2,3,0,1,1
18032,2018-03-21,"07,10,17,32,35","05,12",7,10,17,32,35,5,12,101,28,3,2,17,7,1,1,2,1,2,1,1
18033,2018-03-24,"02,03,19,23,34","04,09",2,3,19,23,34,4,9,81,32,3,2,13,5,1,1,2,2,1,1,1
18034,2018-03-26,"08,11,22,27,32","03,07",8,11,22,27,32,3,7,100,24,2,3,10,4,2,0,2,1,2,1,1
18035,2018-03-28,"05,07,10,12,24","07,11",5,7,10,12,24,7,11,58,19,2,3,18,4,2,0,4,1,0,2,0
18036,2018-03-31,"11,17,18,21,27","07,08",11,17,18,21,27,7,8,94,16,4,1,15,1,1,1,1,3,1,2,0
18037,2018-04-02,"01,03,27,30,31","02,11",1,3,27,30,31,2,11,92,30,4,1,13,9,1,1,2,0,3,1,1
18038,2018-04-04,"14,23,25,31,32","01,03",14,23,25,31,32,1,3,125,18,3,2,4,2,2,0,0,2,3,0,2
18039,2018-04-07,"02,07,14,29,32","10,11",2,7,14,29,32,10,11,84,30,2,3,21,1,1,1,2,1,2,2,0
18040,2018-04-09,"05,07,18,27,31","01,08",5,7,18,27,31,1,8,88,26,4,1,9,7,1,1,2,1,2,1,1
18041,2018-04-11,"01,23,25,31,33","01,12",1,23,25,31,33,1,12,113,32,5,0,13,11,1,1,1,1,3,1,1
18042,2018-04-14,"03,19,25,29,35","05,09",3,19,25,29,35,5,9,111,32,5,0,14,4,2,0,1,1,3,1,1
18043,2018-04-16,"03,06,13,28,33","04,11",3,6,13,28,33,4,11,83,30,3,2,15,7,1,1,2,1,2,1,1
18044,2018-04-18,"02,04,06,18,21","05,08",2,4,6,18,21,5,8,51,19,1,4,13,3,1,1,3,2,0,1,1
18045,2018-04-21,"02,05,20,30,35","05,09",2,5,20,30,35,5,9,92,33,2,3,14,4,2,0,2,1,2,1,1
18046,2018-04-23,"10,20,22,29,32","05,10",10,20,22,29,32,5,10,113,22,1,4,15,5,1,1,1,2,2,1,1
18047,2018-04-25,"03,08,10,14,20","04,08",3,8,10,14,20,4,8,55,17,1,4,12,4,0,2,3,2,0,1,1
18048,2018-04-28,"02,03,11,20,25","02,07",2,3,11,20,25,2,7,61,23,3,2,9,5,1,1,3,1,1,1,1
18049,2018-04-30,"04,07,09,10,13","06,12",4,7,9,10,13,6,12,43,9,3,2,18,6,0,2,4,1,0,1,1
18050,2018-05-02,"22,24,26,34,35","06,12",22,24,26,34,35,6,12,141,13,1,4,18,6,0,2,0,2,3,1,1
18051,2018-05-05,"09,18,28,29,35","03,11",9,18,28,29,35,3,11,119,26,3,2,14,8,2,0,1,1,3,1,1
18052,2018-05-07,"05,16,18,19,25","02,07",5,16,18,19,25,2,7,83,20,3,2,9,5,1,1,1,3,1,1,1
18053,2018-05-09,"11,16,21,23,25","02,12",11,16,21,23,25,2,12,96,14,4,1,14,10,0,2,1,3,1,1,1
18054,2018-05-12,"09,10,12,20,30","01,07",9,10,12,20,30,1,7,81,21,1,4,8,6,2,0,3,1,1,1,1
18055,2018-05-14,"03,07,20,33,34","09,10",3,7,20,33,34,9,10,97,31,3,2,19,1,1,1,2,1,2,2,0
18056,2018-05-16,"02,04,16,28,34","05,07",2,4,16,28,34,5,7,84,32,0,5,12,2,2,0,2,1,2,1,1
18057,2018-05-19,"13,19,22,27,28","05,06",13,19,22,27,28,5,6,109,15,3,2,11,1,1,1,0,3,2,0,2
18058,2018-05-21,"09,11,12,26,32","04,10",9,11,12,26,32,4,10,90,23,2,3,14,6,0,2,3,0,2,1,1
18059,2018-05-23,"01,09,10,27,35","06,11",1,9,10,27,35,6,11,82,34,4,1,17,5,1,1,3,0,2,1,1
18060,2018-05-26,"04,22,27,29,31","02,10",4,22,27,29,31,2,10,113,27,3,2,12,8,0,2,1,1,3,1,1
18061,2018-05-28,"04,10,12,28,31","08,11",4,10,12,28,31,8,11,85,27,1,4,19,3,1,1,3,0,2,2,0
18062,2018-05-30,"12,14,19,23,35","02,07",12,14,19,23,35,2,7,103,23,3,2,9,5,1,1,1,3,1,1,1
18063,2018-06-02,"05,14,15,32,34","03,10",5,14,15,32,34,3,10,100,29,2,3,13,7,1,1,1,2,2,1,1
18064,2018-06-04,"01,03,04,11,29","02,04",1,3,4,11,29,2,4,48,28,4,1,6,2,0,2,4,0,1,0,2
18065,2018-06-06,"07,10,28,31,32","08,10",7,10,28,31,32,8,10,108,25,2,3,18,2,0,2,2,0,3,2,0
18066,2018-06-09,"01,20,23,32,33","01,04",1,20,23,32,33,1,4,109,32,3,2,5,3,1,1,1,2,2,0,2
18067,2018-06-11,"03,07,12,18,31","07,10",3,7,12,18,31,7,10,71,28,3,2,17,3,1,1,3,1,1,2,0
18068,2018-06-13,"08,12,16,26,33","05,06",8,12,16,26,33,5,6,95,25,1,4,11,1,1,1,2,1,2,0,2
18069,2018-06-16,"01,08,13,21,24","02,11",1,8,13,21,24,2,11,67,23,3,2,13,9,1,1,2,3,0,1,1
18070,2018-06-18,"02,05,10,16,30","04,07",2,5,10,16,30,4,7,63,28,1,4,11,3,1,1,3,1,1,1,1
18071,2018-06-20,"02,05,23,30,31","03,09",2,5,23,30,31,3,9,91,29,3,2,12,6,2,0,2,1,2,1,1
18072,2018-06-23,"05,12,17,24,26","01,02",5,12,17,24,26,1,2,84,21,2,3,3,1,1,1,2,2,1,0,2
18073,2018-06-25,"13,19,24,25,29","02,08",13,19,24,25,29,2,8,110,16,4,1,10,6,0,2,0,3,2,1,1
18074,2018-06-27,"03,09,12,28,30","04,12",3,9,12,28,30,4,12,82,27,2,3,16,8,0,2,3,0,2,1,1
18075,2018-06-30,"01,06,12,20,34","04,12",1,6,12,20,34,4,12,73,33,1,4,16,8,0,2,3,1,1,1,1
18076,2018-07-02,"07,18,28,29,32","06,08",7,18,28,29,32,6,8,114,25,2,3,14,2,0,2,1,1,3,1,1
18077,2018-07-04,"01,06,09,15,26","08,09",1,6,9,15,26,8,9,57,25,3,2,17,1,1,1,3,1,1,2,0
18078,2018-07-07,"07,11,12,22,30","03,06",7,11,12,22,30,3,6,82,23,2,3,9,3,1,1,3,1,1,0,2
18079,2018-07-09,"03,04,10,27,29","01,05",3,4,10,27,29,1,5,73,26,3,2,6,4,2,0,3,0,2,0,2
18080,2018-07-11,"07,16,24,26,31","10,11",7,16,24,26,31,10,11,104,24,2,3,21,1,1,1,1,2,2,2,0
18081,2018-07-14,"02,10,13,21,35","01,12",2,10,13,21,35,1,12,81,33,3,2,13,11,1,1,2,2,1,1,1
18082,2018-07-16,"01,02,14,17,18","08,10",1,2,14,17,18,8,10,52,17,2,3,18,2,0,2,2,3,0,2,0
18083,2018-07-18,"07,12,25,27,28","10,11",7,12,25,27,28,10,11,99,21,3,2,21,1,1,1,2,0,3,2,0
18084,2018-07-21,"06,11,17,22,35","11,12",6,11,17,22,35,11,12,91,29,3,2,23,1,1,1,2,2,1,2,0
18085,2018-07-23,"01,02,14,25,31","05,07",1,2,14,25,31,5,7,73,30,3,2,12,2,2,0,2,1,2,1,1
18086,2018-07-25,"16,22,24,29,31","04,05",16,22,24,29,31,4,5,122,15,2,3,9,1,1,1,0,3,2,0,2
18087,2018-07-28,"03,14,19,23,25","01,04",3,14,19,23,25,1,4,84,22,4,1,5,3,1,1,1,3,1,0,2
18088,2018-07-30,"08,09,21,25,33","01,08",8,9,21,25,33,1,8,96,25,4,1,9,7,1,1,2,1,2,1,1
18089,2018-08-01,"26,27,28,32,34","06,10",26,27,28,32,34,6,10,147,8,1,4,16,4,0,2,0,0,5,1,1
18090,2018-08-04,"06,20,24,33,34","04,11",6,20,24,33,34,4,11,117,28,1,4,15,7,1,1,1,2,2,1,1
18091,2018-08-06,"06,22,26,28,31","01,07",6,22,26,28,31,1,7,113,25,1,4,8,6,2,0,1,1,3,1,1
18092,2018-08-08,"05,07,14,18,19","04,10",5,7,14,18,19,4,10,63,14,3,2,14,6,0,2,2,3,0,1,1
18093,2018-08-11,"03,11,16,18,33","03,11",3,11,16,18,33,3,11,81,30,3,2,14,8,2,0,2,2,1,1,1
18094,2018-08-13,"11,16,25,30,34","08,10",11,16,25,30,34,8,10,116,23,2,3,18,2,0,2,1,1,3,2,0
18095,2018-08-15,"07,14,18,29,35","05,12",7,14,18,29,35,5,12,103,28,3,2,17,7,1,1,1,2,2,1,1
18096,2018-08-18,"13,14,20,28,34","06,10",13,14,20,28,34,6,10,109,21,1,4,16,4,0,2,0,3,2,1,1
18097,2018-08-20,"10,12,14,18,23","01,04",10,12,14,18,23,1,4,77,13,1,4,5,3,1,1,2,3,0,0,2
18098,2018-08-22,"02,15,18,25,27","05,07",2,15,18,25,27,5,7,87,25,3,2,12,2,2,0,1,2,2,1,1
18099,2018-08-25,"12,13,16,20,21","01,07",12,13,16,20,21,1,7,82,9,2,3,8,6,2,0,1,4,0,1,1
18100,2018-08-27,"06,20,21,26,30","06,09",6,20,21,26,30,6,9,103,24,1,4,15,3,1,1,1,2,2,1,1
18101,2018-08-29,"03,14,15,23,29","04,05",3,14,15,23,29,4,5,84,26,4,1,9,1,1,1,1,3,1,0,2
18102,2018-09-01,"06,07,13,22,24","10,12",6,7,13,22,24,10,12,72,18,2,3,22,2,0,2,2,3,0,2,0
18103,2018-09-03,"14,24,26,28,35","02,03",14,24,26,28,35,2,3,127,21,1,4,5,1,1,1,0,2,3,0,2
18104,2018-09-05,"01,13,14,26,28","07,11",1,13,14,26,28,7,11,82,27,2,3,18,4,2,0,1,2,2,2,0
18105,2018-09-08,"01,16,19,20,31","02,07",1,16,19,20,31,2,7,87,30,3,2,9,5,1,1,1,3,1,1,1
18106,2018-09-10,"04,14,17,24,31","01,04",4,14,17,24,31,1,4,90,27,2,3,5,3,1,1,1,3,1,0,2
18107,2018-09-12,"07,08,09,10,22","03,04",7,8,9,10,22,3,4,56,15,2,3,7,1,1,1,4,1,0,0,2
18108,2018-09-15,"09,10,24,31,32","07,12",9,10,24,31,32,7,12,106,23,2,3,19,5,1,1,2,1,2,2,0
18109,2018-09-17,"10,16,23,25,34","02,05",10,16,23,25,34,2,5,108,24,2,3,7,3,1,1,1,2,2,0,2
18110,2018-09-19,"06,19,21,27,28","03,11",6,19,21,27,28,3,11,101,22,3,2,14,8,2,0,1,2,2,1,1
18111,2018-09-22,"03,16,27,28,32","04,05",3,16,27,28,32,4,5,106,29,2,3,9,1,1,1,1,1,3,0,2
18112,2018-09-24,"03,07,08,09,29","09,10",3,7,8,9,29,9,10,56,26,4,1,19,1,1,1,4,0,1,2,0
18113,2018-09-26,"08,12,27,31,33","04,08",8,12,27,31,33,4,8,111,25,3,2,12,4,0,2,2,0,3,1,1
18114,2018-09-29,"12,18,26,28,29","05,06",12,18,26,28,29,5,6,113,17,1,4,11,1,1,1,1,1,3,0,2
18115,2018-10-01,"02,06,13,18,25","01,02",2,6,13,18,25,1,2,64,23,2,3,3,1,1,1,2,2,1,0,2
18116,2018-10-03,"01,14,17,21,33","07,10",1,14,17,21,33,7,10,86,32,4,1,17,3,1,1,1,3,1,2,0
18117,2018-10-06,"07,11,13,22,29","03,08",7,11,13,22,29,3,8,82,22,4,1,11,5,1,1,2,2,1,1,1
18118,2018-10-08,"04,05,14,21,34","06,09",4,5,14,21,34,6,9,78,30,2,3,15,3,1,1,2,2,1,1,1
18119,2018-10-10,"06,09,11,16,35","02,05",6,9,11,16,35,2,5,77,29,3,2,7,3,1,1,3,1,1,0,2
18120,2018-10-13,"21,22,25,27,30","08,09",21,22,25,27,30,8,9,125,9,3,2,17,1,1,1,0,2,3,2,0
18121,2018-10-15,"06,07,21,29,30","01,10",6,7,21,29,30,1,10,93,24,3,2,11,9,1,1,2,1,2,1,1
18122,2018-10-17,"08,09,21,30,31","05,12",8,9,21,30,31,5,12,99,23,3,2,17,7,1,1,2,1,2,1,1
18123,2018-10-20,"06,09,29,32,35","02,04",6,9,29,32,35,2,4,111,29,3,2,6,2,0,2,2,0,3,0,2
18124,2018-10-22,"08,10,12,19,20","10,11",8,10,12,19,20,10,11,69,12,1,4,21,1,1,1,3,2,0,2,0
18125,2018-10-24,"07,16,20,21,34","04,06",7,16,20,21,34,4,6,98,27,2,3,10,2,0,2,1,3,1,0,2
18126,2018-10-27,"11,13,15,21,27","05,06",11,13,15,21,27,5,6,87,16,5,0,11,1,1,1,1,3,1,0,2
18127,2018-10-29,"01,03,04,11,29","08,12",1,3,4,11,29,8,12,48,28,4,1,20,4,0,2,4,0,1,2,0
18128,2018-10-31,"11,12,14,16,26","08,09",11,12,14,16,26,8,9,79,15,1,4,17,1,1,1,2,2,1,2,0
18129,2018-11-03,"04,07,21,22,29","03,06",4,7,21,22,29,3,6,83,25,3,2,9,3,1,1,2,2,1,0,2
18130,2018-11-05,"03,04,16,18,25","01,11",3,4,16,18,25,1,11,66,22,2,3,12,10,2,0,2,2,1,1,1
18131,2018-11-07,"12,14,21,32,33","02,11",12,14,21,32,33,2,11,112,21,2,3,13,9,1,1,1,2,2,1,1
18132,2018-11-10,"03,16,22,23,27","01,04",3,16,22,23,27,1,4,91,24,3,2,5,3,1,1,1,3,1,0,2
18133,2018-11-12,"08,12,14,15,19","01,10",8,12,14,15,19,1,10,68,11,2,3,11,9,1,1,2,3,0,1,1
18134,2018-11-14,"04,05,19,31,35","02,12",4,5,19,31,35,2,12,94,31,4,1,14,10,0,2,2,1,2,1,1
18135,2018-11-17,"14,19,23,27,34","06,12",14,19,23,27,34,6,12,117,20,3,2,18,6,0,2,0,3,2,1,1
18136,2018-11-19,"03,11,12,19,21","05,11",3,11,12,19,21,5,11,66,18,4,1,16,6,2,0,3,2,0,1,1
18137,2018-11-21,"07,10,22,23,33","08,11",7,10,22,23,33,8,11,95,26,3,2,19,3,1,1,2,2,1,2,0
18138,2018-11-24,"01,23,24,28,33","04,05",1,23,24,28,33,4,5,109,32,3,2,9,1,1,1,1,2,2,0,2
18139,2018-11-26,"05,11,16,28,35","06,09",5,11,16,28,35,6,9,95,30,3,2,15,3,1,1,2,1,2,1,1
18140,2018-11-28,"01,06,08,12,15","03,04",1,6,8,12,15,3,4,42,14,2,3,7,1,1,1,4,1,0,0,2
18141,2018-12-01,"03,07,23,26,33","04,09",3,7,23,26,33,4,9,92,30,4,1,13,5,1,1,2,1,2,1,1
18142,2018-12-03,"19,24,28,29,34","10,11",19,24,28,29,34,10,11,134,15,2,3,21,1,1,1,0,2,3,2,0
18143,2018-12-05,"04,07,20,22,33","01,02",4,7,20,22,33,1,2,86,29,2,3,3,1,1,1,2,2,1,0,2
18144,2018-12-08,"06,17,18,24,31","07,11",6,17,18,24,31,7,11,96,25,2,3,18,4,2,0,1,3,1,2,0
18145,2018-12-10,"09,18,29,31,33","06,11",9,18,29,31,33,6,11,120,24,4,1,17,5,1,1,1,1,3,1,1
18146,2018-12-12,"03,08,09,13,33","01,02",3,8,9,13,33,1,2,66,30,4,1,3,1,1,1,3,1,1,0,2
18147,2018-12-15,"01,11,26,33,35","02,10",1,11,26,33,35,2,10,106,34,4,1,12,8,0,2,2,0,3,1,1
18148,2018-12-17,"02,06,24,33,34","02,03",2,6,24,33,34,2,3,99,32,1,4,5,1,1,1,2,1,2,0,2
18149,2018-12-19,"01,07,10,11,20","03,06",1,7,10,11,20,3,6,49,19,3,2,9,3,1,1,4,1,0,0,2
18150,2018-12-22,"05,12,13,31,34","10,12",5,12,13,31,34,10,12,95,29,3,2,22,2,0,2,2,1,2,2,0
18151,2018-12-24,"04,08,18,29,30","03,07",4,8,18,29,30,3,7,89,26,1,4,10,4,2,0,2,1,2,1,1
18152,2018-12-26,"02,04,05,12,28","08,11",2,4,5,12,28,8,11,51,26,1,4,19,3,1,1,4,0,1,2,0
18153,2018-12-29,"03,06,07,08,21","01,08",3,6,7,8,21,1,8,45,18,3,2,9,7,1,1,4,1,0,1,1
18154,2018-12-31,"14,22,23,26,30","03,05",14,22,23,26,30,3,5,115,16,1,4,8,2,2,0,0,3,2,0,2
19001,2019-01-02,"06,18,23,26,28","03,12",6,18,23,26,28,3,12,101,22,1,4,15,9,1,1,1,2,2,1,1
19002,2019-01-05,"02,07,14,22,31","01,07",2,7,14,22,31,1,7,76,29,2,3,8,6,2,0,2,2,1,1,1
19003,2019-01-07,"04,08,18,20,32","10,12",4,8,18,20,32,10,12,82,28,0,5,22,2,0,2,2,2,1,2,0
19004,2019-01-09,"15,16,17,31,32","03,09",15,16,17,31,32,3,9,111,17,3,2,12,6,2,0,0,3,2,1,1
19005,2019-01-12,"21,26,27,29,34","05,06",21,26,27,29,34,5,6,137,13,3,2,11,1,1,1,0,1,4,0,2
19006,2019-01-14,"14,17,19,25,30","04,08",14,17,19,25,30,4,8,105,16,3,2,12,4,0,2,0,3,2,1,1
19007,2019-01-16,"03,12,16,29,32","01,05",3,12,16,29,32,1,5,92,29,2,3,6,4,2,0,2,1,2,0,2
19008,2019-01-19,"03,08,17,20,24","06,11",3,8,17,20,24,6,11,72,21,2,3,17,5,1,1,2,3,0,1,1
19009,2019-01-21,"03,09,15,18,26","06,12",3,9,15,18,26,6,12,71,23,3,2,18,6,0,2,2,2,1,1,1
19010,2019-01-23,"03,07,24,25,27","02,12",3,7,24,25,27,2,12,86,24,4,1,14,10,0,2,2,1,2,1,1
19011,2019-01-26,"04,12,13,16,17","04,09",4,12,13,16,17,4,9,62,13,2,3,13,5,1,1,2,3,0,1,1
19012,2019-01-28,"05,09,17,18,19","07,10",5,9,17,18,19,7,10,68,14,4,1,17,3,1,1,2,3,0,2,0
19013,2019-01-30,"08,10,15,17,18","01,08",8,10,15,17,18,1,8,68,10,2,3,9,7,1,1,2,3,0,1,1
19014,2019-02-02,"12,14,20,28,31","09,11",12,14,20,28,31,9,11,105,19,1,4,20,2,2,0,1,2,2,2,0
19015,2019-02-11,"02,05,10,13,30","04,06",2,5,10,13,30,4,6,60,28,2,3,10,2,0,2,3,1,1,0,2
19016,2019-02-13,"03,05,13,16,28","02,06",3,5,13,16,28,2,6,65,25,3,2,8,4,0,2,2,2,1,0,2
19017,2019-02-16,"01,05,07,22,25","03,04",1,5,7,22,25,3,4,60,24,4,1,7,1,1,1,3,1,1,0,2
19018,2019-02-18,"03,18,19,26,34","06,12",3,18,19,26,34,6,12,100,31,2,3,18,6,0,2,1,2,2,1,1
19019,2019-02-20,"04,11,19,25,32","01,02",4,11,19,25,32,1,2,91,28,3,2,3,1,1,1,2,1,2,0,2
19020,2019-02-23,"01,08,16,27,34","03,12",1,8,16,27,34,3,12,86,33,2,3,15,9,1,1,2,1,2,1,1
19021,2019-02-25,"07,13,17,24,33","01,10",7,13,17,24,33,1,10,94,26,4,1,11,9,1,1,1,3,1,1,1
19022,2019-02-27,"01,04,14,15,21","01,05",1,4,14,15,21,1,5,55,20,3,2,6,4,2,0,2,3,0,0,2
19023,2019-03-02,"01,03,14,26,30","06,11",1,3,14,26,30,6,11,74,29,2,3,17,5,1,1,2,1,2,1,1
19024,2019-03-04,"11,17,19,29,33","08,09",11,17,19,29,33,8,9,109,22,5,0,17,1,1,1,1,2,2,2,0
19025,2019-03-06,"06,13,16,19,29","03,07",6,13,16,19,29,3,7,83,23,3,2,10,4,2,0,1,3,1,1,1
19026,2019-03-09,"10,12,15,17,19","02,03",10,12,15,17,19,2,3,73,9,3,2,5,1,1,1,2,3,0,0,2
19027,2019-03-11,"16,18,24,25,27","02,07",16,18,24,25,27,2,7,110,11,2,3,9,5,1,1,0,3,2,1,1
19028,2019-03-13,"06,22,28,29,33","02,07",6,22,28,29,33,2,7,118,27,2,3,9,5,1,1,1,1,3,1,1
19029,2019-03-16,"01,04,18,24,28","02,03",1,4,18,24,28,2,3,75,27,1,4,5,1,1,1,2,2,1,0,2
19030,2019-03-18,"07,09,13,14,33","02,04",7,9,13,14,33,2,4,76,26,4,1,6,2,0,2,2,2,1,0,2
19031,2019-03-20,"03,08,21,26,33","04,05",3,8,21,26,33,4,5,91,30,3,2,9,1,1,1,2,1,2,0,2
19032,2019-03-23,"01,04,07,11,30","07,08",1,4,7,11,30,7,8,53,29,3,2,15,1,1,1,4,0,1,2,0
19033,2019-03-25,"01,02,04,16,24","07,09",1,2,4,16,24,7,9,47,23,1,4,16,2,2,0,3,2,0,2,0
19034,2019-03-27,"08,12,15,27,30","01,02",8,12,15,27,30,1,2,92,22,2,3,3,1,1,1,2,1,2,0,2
19035,2019-03-30,"01,03,05,07,18","08,09",1,3,5,7,18,8,9,34,17,4,1,17,1,1,1,4,1,0,2,0
19036,2019-04-01,"03,09,21,28,30","01,12",3,9,21,28,30,1,12,91,27,3,2,13,11,1,1,2,1,2,1,1
19037,2019-04-03,"06,16,26,33,35","04,08",6,16,26,33,35,4,8,116,29,2,3,12,4,0,2,1,1,3,1,1
19038,2019-04-06,"05,11,16,18,27","07,12",5,11,16,18,27,7,12,77,22,3,2,19,5,1,1,2,2,1,2,0
19039,2019-04-08,"01,12,18,26,35","06,12",1,12,18,26,35,6,12,92,34,2,3,18,6,0,2,2,1,2,1,1
19040,2019-04-10,"01,03,31,32,34","01,03",1,3,31,32,34,1,3,101,33,3,2,4,2,2,0,2,0,3,0,2
19041,2019-04-13,"12,19,20,22,28","02,06",12,19,20,22,28,2,6,101,16,1,4,8,4,0,2,1,3,1,0,2
19042,2019-04-15,"04,10,13,28,33","11,12",4,10,13,28,33,11,12,88,29,2,3,23,1,1,1,2,1,2,2,0
19043,2019-04-17,"02,06,07,12,15","06,12",2,6,7,12,15,6,12,42,13,2,3,18,6,0,2,4,1,0,1,1
19044,2019-04-20,"03,06,10,12,31","01,02",3,6,10,12,31,1,2,62,28,2,3,3,1,1,1,4,0,1,0,2
19045,2019-04-22,"01,04,16,19,33","03,12",1,4,16,19,33,3,12,73,32,3,2,15,9,1,1,2,2,1,1,1
19046,2019-04-24,"02,08,14,15,35","10,12",2,8,14,15,35,10,12,74,33,2,3,22,2,0,2,2,2,1,2,0
19047,2019-04-27,"03,04,10,16,32","04,09",3,4,10,16,32,4,9,65,29,1,4,13,5,1,1,3,1,1,1,1
19048,2019-04-29,"06,10,16,29,33","05,11",6,10,16,29,33,5,11,94,27,2,3,16,6,2,0,2,1,2,1,1
19049,2019-05-01,"10,16,22,26,27","07,11",10,16,22,26,27,7,11,101,17,1,4,18,4,2,0,1,2,2,2,0
19050,2019-05-04,"04,15,16,20,35","03,12",4,15,16,20,35,3,12,90,31,2,3,15,9,1,1,1,3,1,1,1
19051,2019-05-06,"11,15,16,20,29","04,08",11,15,16,20,29,4,8,91,18,3,2,12,4,0,2,1,3,1,1,1
19052,2019-05-08,"04,10,15,20,24","07,11",4,10,15,20,24,7,11,73,20,1,4,18,4,2,0,2,3,0,2,0
19053,2019-05-11,"01,11,19,26,35","11,12",1,11,19,26,35,11,12,92,34,4,1,23,1,1,1,2,1,2,2,0
19054,2019-05-13,"02,18,23,27,30","05,10",2,18,23,27,30,5,10,100,28,2,3,15,5,1,1,1,2,2,1,1
19055,2019-05-15,"02,04,06,19,22","02,06",2,4,6,19,22,2,6,53,20,1,4,8,4,0,2,3,2,0,0,2
19056,2019-05-18,"01,07,10,12,23","06,08",1,7,10,12,23,6,8,53,22,3,2,14,2,0,2,4,1,0,1,1
19057,2019-05-20,"08,14,16,34,35","06,12",8,14,16,34,35,6,12,107,27,1,4,18,6,0,2,1,2,2,1,1
19058,2019-05-22,"03,10,13,14,32","07,11",3,10,13,14,32,7,11,72,29,2,3,18,4,2,0,2,2,1,2,0
19059,2019-05-25,"07,08,15,27,32","08,12",7,8,15,27,32,8,12,89,25,3,2,20,4,0,2,2,1,2,2,0
19060,2019-05-27,"01,11,12,18,21","08,10",1,11,12,18,21,8,10,63,20,3,2,18,2,0,2,3,2,0,2,0
19061,2019-05-29,"01,02,13,14,26","05,11",1,2,13,14,26,5,11,56,25,2,3,16,6,2,0,2,2,1,1,1
19062,2019-06-01,"05,16,23,25,28","01,12",5,16,23,25,28,1,12,97,23,3,2,13,11,1,1,1,2,2,1,1
19063,2019-06-03,"05,08,15,18,21","04,08",5,8,15,18,21,4,8,67,16,3,2,12,4,0,2,2,3,0,1,1
19064,2019-06-05,"07,08,13,19,29","11,12",7,8,13,19,29,11,12,76,22,4,1,23,1,1,1,2,2,1,2,0
19065,2019-06-08,"03,08,10,23,27","02,12",3,8,10,23,27,2,12,71,24,3,2,14,10,0,2,3,1,1,1,1
19066,2019-06-10,"04,10,11,18,31","05,08",4,10,11,18,31,5,8,74,27,2,3,13,3,1,1,3,1,1,1,1
19067,2019-06-12,"03,08,11,15,16","02,10",3,8,11,15,16,2,10,53,13,3,2,12,8,0,2,3,2,0,1,1
19068,2019-06-15,"04,05,08,17,27","06,11",4,5,8,17,27,6,11,61,23,3,2,17,5,1,1,3,1,1,1,1
19069,2019-06-17,"08,22,23,33,34","04,06",8,22,23,33,34,4,6,120,26,2,3,10,2,0,2,1,2,2,0,2
19070,2019-06-19,"02,13,15,22,34","02,12",2,13,15,22,34,2,12,86,32,2,3,14,10,0,2,1,3,1,1,1
19071,2019-06-22,"07,13,14,15,22","07,11",7,13,14,15,22,7,11,71,15,3,2,18,4,2,0,1,4,0,2,0
19072,2019-06-24,"02,04,06,09,18","07,10",2,4,6,9,18,7,10,39,16,1,4,17,3,1,1,4,1,0,2,0
19073,2019-06-26,"04,11,19,20,24","08,11",4,11,19,20,24,8,11,78,20,2,3,19,3,1,1,2,3,0,2,0
19074,2019-06-29,"08,09,13,14,34","05,07",8,9,13,14,34,5,7,78,26,2,3,12,2,2,0,2,2,1,1,1
19075,2019-07-01,"05,06,07,11,16","02,11",5,6,7,11,16,2,11,45,11,3,2,13,9,1,1,4,1,0,1,1
19076,2019-07-03,"01,06,11,23,29","01,11",1,6,11,23,29,1,11,70,28,4,1,12,10,2,0,3,1,1,1,1
19077,2019-07-06,"01,15,17,21,33","07,10",1,15,17,21,33,7,10,87,32,5,0,17,3,1,1,1,3,1,2,0
19078,2019-07-08,"05,10,21,26,30","01,07",5,10,21,26,30,1,7,92,25,2,3,8,6,2,0,2,1,2,1,1
19079,2019-07-10,"10,13,16,28,35","04,05",10,13,16,28,35,4,5,102,25,2,3,9,1,1,1,1,2,2,0,2
19080,2019-07-13,"05,13,18,19,24","02,07",5,13,18,19,24,2,7,79,19,3,2,9,5,1,1,1,4,0,1,1
19081,2019-07-15,"06,24,26,30,33","02,07",6,24,26,30,33,2,7,119,27,1,4,9,5,1,1,1,1,3,1,1
19082,2019-07-17,"06,18,20,21,31","03,04",6,18,20,21,31,3,4,96,25,2,3,7,1,1,1,1,3,1,0,2
19083,2019-07-20,"17,24,26,28,32","07,09",17,24,26,28,32,7,9,127,15,1,4,16,2,2,0,0,2,3,2,0
19084,2019-07-22,"12,23,25,34,35","01,07",12,23,25,34,35,1,7,129,23,3,2,8,6,2,0,1,1,3,1,1
19085,2019-07-24,"04,05,06,15,26","08,11",4,5,6,15,26,8,11,56,22,2,3,19,3,1,1,3,1,1,2,0
19086,2019-07-27,"05,15,16,28,31","02,07",5,15,16,28,31,2,7,95,26,3,2,9,5,1,1,1,2,2,1,1
19087,2019-07-29,"05,06,18,19,27","07,12",5,6,18,19,27,7,12,75,22,3,2,19,5,1,1,2,2,1,2,0
19088,2019-07-31,"01,05,18,27,33","06,08",1,5,18,27,33,6,8,84,32,4,1,14,2,0,2,2,1,2,1,1
19089,2019-08-03,"09,14,18,33,34","03,12",9,14,18,33,34,3,12,108,25,2,3,15,9,1,1,1,2,2,1,1
19090,2019-08-05,"13,19,28,30,33","02,12",13,19,28,30,33,2,12,123,20,3,2,14,10,0,2,0,2,3,1,1
19091,2019-08-07,"04,13,20,26,28","03,12",4,13,20,26,28,3,12,91,24,1,4,15,9,1,1,1,2,2,1,1
19092,2019-08-10,"02,11,15,27,30","02,05",2,11,15,27,30,2,5,85,28,3,2,7,3,1,1,2,1,2,0,2
19093,2019-08-12,"16,17,26,29,35","01,07",16,17,26,29,35,1,7,123,19,3,2,8,6,2,0,0,2,3,1,1
19094,2019-08-14,"01,12,14,26,27","07,09",1,12,14,26,27,7,9,80,26,2,3,16,2,2,0,2,1,2,2,0
19095,2019-08-17,"03,12,17,19,31","02,06",3,12,17,19,31,2,6,82,28,4,1,8,4,0,2,2,2,1,0,2
19096,2019-08-19,"02,12,22,23,27","02,06",2,12,22,23,27,2,6,86,25,2,3,8,4,0,2,2,2,1,0,2
19097,2019-08-21,"10,17,20,30,35","10,12",10,17,20,30,35,10,12,112,25,2,3,22,2,0,2,1,2,2,2,0
19098,2019-08-24,"13,15,17,19,22","03,04",13,15,17,19,22,3,4,86,9,4,1,7,1,1,1,0,5,0,0,2
19099,2019-08-26,"04,06,18,27,33","07,09",4,6,18,27,33,7,9,88,29,2,3,16,2,2,0,2,1,2,2,0
19100,2019-08-28,"05,08,12,19,21","06,11",5,8,12,19,21,6,11,65,16,3,2,17,5,1,1,3,2,0,1,1
19101,2019-08-31,"05,11,18,19,27","05,06",5,11,18,19,27,5,6,80,22,4,1,11,1,1,1,2,2,1,0,2
19102,2019-09-02,"05,10,15,19,31","03,06",5,10,15,19,31,3,6,80,26,4,1,9,3,1,1,2,2,1,0,2
19103,2019-09-04,"05,12,22,27,32","04,07",5,12,22,27,32,4,7,98,27,2,3,11,3,1,1,2,1,2,1,1
19104,2019-09-07,"02,07,19,22,28","03,05",2,7,19,22,28,3,5,78,26,2,3,8,2,2,0,2,2,1,0,2
19105,2019-09-09,"01,04,09,14,17","01,06",1,4,9,14,17,1,6,45,16,3,2,7,5,1,1,3,2,0,0,2
19106,2019-09-11,"05,08,10,32,35","02,10",5,8,10,32,35,2,10,90,30,2,3,12,8,0,2,3,0,2,1,1
19107,2019-09-14,"05,09,19,27,35","02,03",5,9,19,27,35,2,3,95,30,5,0,5,1,1,1,2,1,2,0,2
19108,2019-09-16,"24,27,28,31,34","04,08",24,27,28,31,34,4,8,144,10,2,3,12,4,0,2,0,1,4,1,1
19109,2019-09-18,"02,07,08,20,25","11,12",2,7,8,20,25,11,12,62,23,2,3,23,1,1,1,3,1,1,2,0
19110,2019-09-21,"01,19,23,24,30","04,05",1,19,23,24,30,4,5,97,29,3,2,9,1,1,1,1,3,1,0,2
19111,2019-09-23,"06,15,20,23,27","08,10",6,15,20,23,27,8,10,91,21,3,2,18,2,0,2,1,3,1,2,0
19112,2019-09-25,"03,10,16,21,33","05,06",3,10,16,21,33,5,6,83,30,3,2,11,1,1,1,2,2,1,0,2
19113,2019-09-28,"03,11,27,34,35","01,02",3,11,27,34,35,1,2,110,32,4,1,3,1,1,1,2,0,3,0,2
19114,2019-09-30,"03,05,07,20,23","04,11",3,5,7,20,23,4,11,58,20,4,1,15,7,1,1,3,2,0,1,1
19115,2019-10-09,"01,18,21,28,32","05,12",1,18,21,28,32,5,12,100,31,2,3,17,7,1,1,1,2,2,1,1
19116,2019-10-12,"02,10,16,21,23","02,12",2,10,16,21,23,2,12,72,21,2,3,14,10,0,2,2,3,0,1,1
19117,2019-10-14,"01,18,21,25,35","07,08",1,18,21,25,35,7,8,100,34,4,1,15,1,1,1,1,2,2,2,0
19118,2019-10-16,"02,03,13,19,26","02,03",2,3,13,19,26,2,3,63,24,3,2,5,1,1,1,2,2,1,0,2
19119,2019-10-19,"03,06,09,23,34","02,11",3,6,9,23,34,2,11,75,31,3,2,13,9,1,1,3,1,1,1,1
19120,2019-10-21,"06,15,17,22,25","01,09",6,15,17,22,25,1,9,85,19,3,2,10,8,2,0,1,3,1,1,1
19121,2019-10-23,"01,02,03,07,17","04,10",1,2,3,7,17,4,10,30,16,4,1,14,6,0,2,4,1,0,1,1
19122,2019-10-26,"05,19,25,31,33","10,11",5,19,25,31,33,10,11,113,28,5,0,21,1,1,1,1,1,3,2,0
19123,2019-10-28,"03,13,15,26,30","05,12",3,13,15,26,30,5,12,87,27,3,2,17,7,1,1,1,2,2,1,1
19124,2019-10-30,"07,17,26,27,30","06,12",7,17,26,27,30,6,12,107,23,3,2,18,6,0,2,1,1,3,1,1
19125,2019-11-02,"05,08,09,14,34","02,05",5,8,9,14,34,2,5,70,29,2,3,7,3,1,1,3,1,1,0,2
19126,2019-11-04,"05,09,16,18,30","04,07",5,9,16,18,30,4,7,78,25,2,3,11,3,1,1,2,2,1,1,1
19127,2019-11-06,"04,07,08,11,16","09,11",4,7,8,11,16,9,11,46,12,2,3,20,2,2,0,4,1,0,2,0
19128,2019-11-09,"20,21,25,34,35","03,12",20,21,25,34,35,3,12,135,15,3,2,15,9,1,1,0,2,3,1,1
19129,2019-11-11,"10,13,18,23,30","06,12",10,13,18,23,30,6,12,94,20,2,3,18,6,0,2,1,3,1,1,1
19130,2019-11-13,"01,13,20,21,26","04,10",1,13,20,21,26,4,10,81,25,3,2,14,6,0,2,1,3,1,1,1
19131,2019-11-16,"05,06,14,27,29","06,10",5,6,14,27,29,6,10,81,24,3,2,16,4,0,2,2,1,2,1,1
19132,2019-11-18,"03,05,06,13,18","10,12",3,5,6,13,18,10,12,45,15,3,2,22,2,0,2,3,2,0,2,0
19133,2019-11-20,"03,12,24,27,34","01,12",3,12,24,27,34,1,12,100,31,2,3,13,11,1,1,2,1,2,1,1
19134,2019-11-23,"05,06,07,14,17","10,11",5,6,7,14,17,10,11,49,12,3,2,21,1,1,1,3,2,0,2,0
19135,2019-11-25,"04,05,19,25,26","01,11",4,5,19,25,26,1,11,79,22,3,2,12,10,2,0,2,1,2,1,1
19136,2019-11-27,"03,16,20,26,29","03,09",3,16,20,26,29,3,9,94,26,2,3,12,6,2,0,1,2,2,1,1
19137,2019-11-30,"03,05,12,13,26","07,12",3,5,12,13,26,7,12,59,23,3,2,19,5,1,1,3,1,1,2,0
19138,2019-12-02,"04,06,07,20,29","02,04",4,6,7,20,29,2,4,66,25,2,3,6,2,0,2,3,1,1,0,2
19139,2019-12-04,"01,05,07,08,11","06,10",1,5,7,8,11,6,10,32,10,4,1,16,4,0,2,5,0,0,1,1
19140,2019-12-07,"03,07,08,25,27","03,05",3,7,8,25,27,3,5,70,24,4,1,8,2,2,0,3,0,2,0,2
19141,2019-12-09,"02,10,20,21,35","01,12",2,10,20,21,35,1,12,88,33,2,3,13,11,1,1,2,2,1,1,1
19142,2019-12-11,"03,04,26,29,33","06,07",3,4,26,29,33,6,7,95,30,3,2,13,1,1,1,2,0,3,1,1
19143,2019-12-14,"04,22,23,24,32","06,12",4,22,23,24,32,6,12,105,28,1,4,18,6,0,2,1,3,1,1,1
19144,2019-12-16,"02,05,20,28,31","02,11",2,5,20,28,31,2,11,86,29,2,3,13,9,1,1,2,1,2,1,1
19145,2019-12-18,"05,09,19,22,32","03,05",5,9,19,22,32,3,5,87,27,3,2,8,2,2,0,2,2,1,0,2
19146,2019-12-21,"10,11,26,33,34","01,06",10,11,26,33,34,1,6,114,24,2,3,7,5,1,1,2,0,3,0,2
19147,2019-12-23,"09,12,19,22,33","07,08",9,12,19,22,33,7,8,95,24,3,2,15,1,1,1,2,2,1,2,0
19148,2019-12-25,"03,04,07,11,30","08,09",3,4,7,11,30,8,9,55,27,3,2,17,1,1,1,4,0,1,2,0
19149,2019-12-28,"01,02,07,33,35","06,10",1,2,7,33,35,6,10,78,34,4,1,16,4,0,2,3,0,2,1,1
19150,2019-12-30,"07,11,12,16,33","05,07",7,11,12,16,33,5,7,79,26,3,2,12,2,2,0,3,1,1,1,1
20001,2020-01-01,"17,25,26,32,34","04,07",17,25,26,32,34,4,7,134,17,2,3,11,3,1,1,0,1,4,1,1
20002,2020-01-04,"03,07,18,25,30","02,07",3,7,18,25,30,2,7,83,27,3,2,9,5,1,1,2,1,2,1,1
20003,2020-01-06,"23,25,26,30,34","03,07",23,25,26,30,34,3,7,138,11,2,3,10,4,2,0,0,1,4,1,1
20004,2020-01-08,"17,20,21,29,30","05,09",17,20,21,29,30,5,9,117,13,3,2,14,4,2,0,0,3,2,1,1
20005,2020-01-11,"06,10,33,34,35","01,03",6,10,33,34,35,1,3,118,29,2,3,4,2,2,0,2,0,3,0,2
20006,2020-01-13,"09,22,25,31,32","08,12",9,22,25,31,32,8,12,119,23,3,2,20,4,0,2,1,1,3,2,0
20007,2020-01-15,"02,10,19,24,30","05,08",2,10,19,24,30,5,8,85,28,1,4,13,3,1,1,2,2,1,1,1
20008,2020-01-18,"14,17,19,24,32","01,06",14,17,19,24,32,1,6,106,18,2,3,7,5,1,1,0,4,1,0,2
20009,2020-01-20,"19,29,31,34,35","06,10",19,29,31,34,35,6,10,148,16,4,1,16,4,0,2,0,1,4,1,1
20010,2020-03-14,"01,08,13,24,32","02,09",1,8,13,24,32,2,9,78,31,2,3,11,7,1,1,2,2,1,1,1
20011,2020-03-16,"02,13,19,22,23","02,07",2,13,19,22,23,2,7,79,21,3,2,9,5,1,1,1,4,0,1,1
20012,2020-03-18,"01,06,18,32,34","01,03",1,6,18,32,34,1,3,91,33,1,4,4,2,2,0,2,1,2,0,2
20013,2020-03-21,"01,04,05,11,35","03,09",1,4,5,11,35,3,9,56,34,4,1,12,6,2,0,4,0,1,1,1
20014,2020-03-23,"03,07,09,17,21","03,06",3,7,9,17,21,3,6,57,18,5,0,9,3,1,1,3,2,0,0,2
20015,2020-03-25,"01,07,23,24,26","03,07",1,7,23,24,26,3,7,81,25,3,2,10,4,2,0,2,2,1,1,1
20016,2020-03-28,"04,08,19,31,35","01,02",4,8,19,31,35,1,2,97,31,3,2,3,1,1,1,2,1,2,0,2
20017,2020-03-30,"01,06,07,09,10","02,11",1,6,7,9,10,2,11,33,9,3,2,13,9,1,1,5,0,0,1,1
20018,2020-04-01,"09,14,16,24,26","04,12",9,14,16,24,26,4,12,89,17,1,4,16,8,0,2,1,3,1,1,1
20019,2020-04-04,"01,12,22,23,33","01,12",1,12,22,23,33,1,12,91,32,3,2,13,11,1,1,2,2,1,1,1
20020,2020-04-06,"08,10,12,26,32","05,09",8,10,12,26,32,5,9,88,24,0,5,14,4,2,0,3,0,2,1,1
20021,2020-04-08,"10,12,24,31,33","04,09",10,12,24,31,33,4,9,110,23,2,3,13,5,1,1,2,1,2,1,1
20022,2020-04-11,"04,14,20,28,35","02,03",4,14,20,28,35,2,3,101,31,1,4,5,1,1,1,1,2,2,0,2
20023,2020-04-13,"04,11,23,26,30","01,06",4,11,23,26,30,1,6,94,26,2,3,7,5,1,1,2,1,2,0,2
20024,2020-04-15,"03,05,06,24,30","03,07",3,5,6,24,30,3,7,68,27,2,3,10,4,2,0,3,1,1,1,1
20025,2020-04-18,"02,14,21,22,26","05,07",2,14,21,22,26,5,7,85,24,1,4,12,2,2,0,1,3,1,1,1
20026,2020-04-20,"03,15,26,32,34","08,12",3,15,26,32,34,8,12,110,31,2,3,20,4,0,2,1,1,3,2,0
20027,2020-04-22,"04,07,20,25,32","03,09",4,7,20,25,32,3,9,88,28,2,3,12,6,2,0,2,1,2,1,1
20028,2020-04-25,"04,05,28,34,35","01,08",4,5,28,34,35,1,8,106,31,2,3,9,7,1,1,2,0,3,1,1
20029,2020-04-27,"11,14,17,22,30","07,09",11,14,17,22,30,7,9,94,19,2,3,16,2,2,0,1,3,1,2,0
20030,2020-04-29,"01,08,17,27,30","05,06",1,8,17,27,30,5,6,83,29,3,2,11,1,1,1,2,1,2,0,2
20031,2020-05-02,"01,02,05,15,21","04,05",1,2,5,15,21,4,5,44,20,4,1,9,1,1,1,3,2,0,0,2
20032,2020-05-04,"02,03,09,16,32","03,04",2,3,9,16,32,3,4,62,30,2,3,7,1,1,1,3,1,1,0,2
20033,2020-05-06,"07,19,20,31,34","05,08",7,19,20,31,34,5,8,111,27,3,2,13,3,1,1,1,2,2,1,1
20034,2020-05-09,"11,13,20,27,31","02,04",11,13,20,27,31,2,4,102,20,4,1,6,2,0,2,1,2,2,0,2
20035,2020-05-11,"10,11,22,26,28","02,04",10,11,22,26,28,2,4,97,18,1,4,6,2,0,2,2,1,2,0,2
20036,2020-05-13,"01,05,11,12,26","02,07",1,5,11,12,26,2,7,55,25,3,2,9,5,1,1,4,0,1,1,1
20037,2020-05-16,"01,04,10,11,14","02,05",1,4,10,11,14,2,5,40,13,2,3,7,3,1,1,4,1,0,0,2
20038,2020-05-18,"04,15,20,22,24","01,09",4,15,20,22,24,1,9,85,20,1,4,10,8,2,0,1,4,0,1,1
20039,2020-05-20,"01,05,15,22,31","02,09",1,5,15,22,31,2,9,74,30,4,1,11,7,1,1,2,2,1,1,1
20040,2020-05-23,"02,17,20,28,29","01,07",2,17,20,28,29,1,7,96,27,2,3,8,6,2,0,1,2,2,1,1
20041,2020-05-25,"07,13,20,29,34","04,07",7,13,20,29,34,4,7,103,27,3,2,11,3,1,1,1,2,2,1,1
20042,2020-05-27,"03,04,05,11,22","05,06",3,4,5,11,22,5,6,45,19,3,2,11,1,1,1,4,1,0,0,2
20043,2020-05-30,"12,13,17,31,32","01,06",12,13,17,31,32,1,6,105,20,3,2,7,5,1,1,1,2,2,0,2
20044,2020-06-01,"01,03,22,28,30","02,05",1,3,22,28,30,2,5,84,29,2,3,7,3,1,1,2,1,2,0,2
20045,2020-06-03,"02,09,16,23,27","03,08",2,9,16,23,27,3,8,77,25,3,2,11,5,1,1,2,2,1,1,1
20046,2020-06-06,"15,24,27,30,34","04,12",15,24,27,30,34,4,12,130,19,2,3,16,8,0,2,0,2,3,1,1
20047,2020-06-08,"04,18,27,28,30","03,10",4,18,27,28,30,3,10,107,26,1,4,13,7,1,1,1,1,3,1,1
20048,2020-06-10,"03,09,10,15,16","07,09",3,9,10,15,16,7,9,53,13,3,2,16,2,2,0,3,2,0,2,0
20049,2020-06-13,"03,11,15,22,30","08,10",3,11,15,22,30,8,10,81,27,3,2,18,2,0,2,2,2,1,2,0
20050,2020-06-15,"03,14,16,22,34","02,06",3,14,16,22,34,2,6,89,31,1,4,8,4,0,2,1,3,1,0,2
20051,2020-06-17,"02,07,09,19,33","01,07",2,7,9,19,33,1,7,70,31,4,1,8,6,2,0,3,1,1,1,1
20052,2020-06-20,"09,11,26,28,35","06,07",9,11,26,28,35,6,7,109,26,3,2,13,1,1,1,2,0,3,1,1
20053,2020-06-22,"02,15,18,21,27","03,06",2,15,18,21,27,3,6,83,25,3,2,9,3,1,1,1,3,1,0,2
20054,2020-06-24,"11,14,15,19,20","03,07",11,14,15,19,20,3,7,79,9,3,2,10,4,2,0,1,4,0,1,1
20055,2020-06-27,"03,04,12,18,34","10,12",3,4,12,18,34,10,12,71,31,1,4,22,2,0,2,3,1,1,2,0
20056,2020-06-29,"03,11,25,29,34","03,06",3,11,25,29,34,3,6,102,31,4,1,9,3,1,1,2,0,3,0,2
20057,2020-07-01,"17,20,21,22,31","02,08",17,20,21,22,31,2,8,111,14,3,2,10,6,0,2,0,4,1,1,1
20058,2020-07-04,"01,15,19,26,27","05,10",1,15,19,26,27,5,10,88,26,4,1,15,5,1,1,1,2,2,1,1
20059,2020-07-06,"01,15,22,28,32","03,11",1,15,22,28,32,3,11,98,31,2,3,14,8,2,0,1,2,2,1,1
20060,2020-07-08,"12,14,25,34,35","03,12",12,14,25,34,35,3,12,120,23,2,3,15,9,1,1,1,1,3,1,1
20061,2020-07-11,"07,08,12,21,26","01,06",7,8,12,21,26,1,6,74,19,2,3,7,5,1,1,3,1,1,0,2
20062,2020-07-13,"01,05,14,23,31","02,07",1,5,14,23,31,2,7,74,30,4,1,9,5,1,1,2,2,1,1,1
20063,2020-07-15,"11,18,20,21,33","06,07",11,18,20,21,33,6,7,103,22,3,2,13,1,1,1,1,3,1,1,1
20064,2020-07-18,"05,10,23,34,35","01,11",5,10,23,34,35,1,11,107,30,3,2,12,10,2,0,2,1,2,1,1
20065,2020-07-20,"13,15,26,32,33","05,07",13,15,26,32,33,5,7,119,20,3,2,12,2,2,0,0,2,3,1,1
20066,2020-07-22,"06,14,21,34,35","03,10",6,14,21,34,35,3,10,110,29,2,3,13,7,1,1,1,2,2,1,1
20067,2020-07-25,"01,08,14,16,28","04,10",1,8,14,16,28,4,10,67,27,1,4,14,6,0,2,2,2,1,1,1
20068,2020-07-27,"15,20,23,26,33","02,08",15,20,23,26,33,2,8,117,18,3,2,10,6,0,2,0,3,2,1,1
20069,2020-07-29,"05,07,26,30,31","07,10",5,7,26,30,31,7,10,99,26,3,2,17,3,1,1,2,0,3,2,0
20070,2020-08-01,"01,22,30,31,32","04,12",1,22,30,31,32,4,12,116,31,2,3,16,8,0,2,1,1,3,1,1
20071,2020-08-03,"01,12,16,28,33","03,12",1,12,16,28,33,3,12,90,32,2,3,15,9,1,1,2,1,2,1,1
20072,2020-08-05,"11,15,18,20,27","05,06",11,15,18,20,27,5,6,91,16,3,2,11,1,1,1,1,3,1,0,2
20073,2020-08-08,"04,10,12,23,27","08,09",4,10,12,23,27,8,9,76,23,2,3,17,1,1,1,3,1,1,2,0
20074,2020-08-10,"03,09,10,12,21","04,11",3,9,10,12,21,4,11,55,18,3,2,15,7,1,1,4,1,0,1,1
20075,2020-08-12,"02,09,10,21,35","01,07",2,9,10,21,35,1,7,77,33,3,2,8,6,2,0,3,1,1,1,1
20076,2020-08-15,"01,08,18,28,30","10,12",1,8,18,28,30,10,12,85,29,1,4,22,2,0,2,2,1,2,2,0
20077,2020-08-17,"17,23,28,29,32","01,03",17,23,28,29,32,1,3,129,15,3,2,4,2,2,0,0,2,3,0,2
20078,2020-08-19,"14,18,20,28,34","10,11",14,18,20,28,34,10,11,114,20,0,5,21,1,1,1,0,3,2,2,0
20079,2020-08-22,"04,16,24,29,35","02,12",4,16,24,29,35,2,12,108,31,2,3,14,10,0,2,1,2,2,1,1
20080,2020-08-24,"03,06,22,24,25","09,10",3,6,22,24,25,9,10,80,22,2,3,19,1,1,1,2,2,1,2,0
20081,2020-08-26,"01,13,15,32,35","08,10",1,13,15,32,35,8,10,96,34,4,1,18,2,0,2,1,2,2,2,0
20082,2020-08-29,"02,11,12,21,34","04,08",2,11,12,21,34,4,8,80,32,2,3,12,4,0,2,3,1,1,1,1
20083,2020-08-31,"01,02,17,32,34","04,09",1,2,17,32,34,4,9,86,33,2,3,13,5,1,1,2,1,2,1,1
20084,2020-09-02,"02,10,20,24,31","06,12",2,10,20,24,31,6,12,87,29,1,4,18,6,0,2,2,2,1,1,1
20085,2020-09-05,"03,04,11,15,28","02,03",3,4,11,15,28,2,3,61,25,3,2,5,1,1,1,3,1,1,0,2
20086,2020-09-07,"08,11,15,20,28","04,10",8,11,15,20,28,4,10,82,20,2,3,14,6,0,2,2,2,1,1,1
20087,2020-09-09,"01,04,20,23,29","04,08",1,4,20,23,29,4,8,77,28,3,2,12,4,0,2,2,2,1,1,1
20088,2020-09-12,"02,07,23,26,35","01,12",2,7,23,26,35,1,12,93,33,3,2,13,11,1,1,2,1,2,1,1
20089,2020-09-14,"13,16,20,22,27","01,02",13,16,20,22,27,1,2,98,14,2,3,3,1,1,1,0,4,1,0,2
20090,2020-09-16,"05,06,27,28,29","11,12",5,6,27,28,29,11,12,95,24,3,2,23,1,1,1,2,0,3,2,0
20091,2020-09-19,"12,16,20,23,31","05,12",12,16,20,23,31,5,12,102,19,2,3,17,7,1,1,1,3,1,1,1
20092,2020-09-21,"08,11,17,31,35","07,11",8,11,17,31,35,7,11,102,27,4,1,18,4,2,0,2,1,2,2,0
20093,2020-09-23,"06,14,25,27,28","04,11",6,14,25,27,28,4,11,100,22,2,3,15,7,1,1,1,1,3,1,1
20094,2020-09-26,"04,06,07,08,16","02,08",4,6,7,8,16,2,8,41,12,1,4,10,6,0,2,4,1,0,1,1
20095,2020-09-28,"02,18,25,26,32","02,07",2,18,25,26,32,2,7,103,30,1,4,9,5,1,1,1,1,3,1,1
20096,2020-09-30,"07,08,10,25,28","03,11",7,8,10,25,28,3,11,78,21,2,3,14,8,2,0,3,0,2,1,1
20097,2020-10-05,"05,25,27,30,34","06,12",5,25,27,30,34,6,12,121,29,3,2,18,6,0,2,1,0,4,1,1
20098,2020-10-07,"04,09,15,24,35","04,10",4,9,15,24,35,4,10,87,31,3,2,14,6,0,2,2,2,1,1,1
20099,2020-10-10,"02,03,11,15,27","04,12",2,3,11,15,27,4,12,58,25,4,1,16,8,0,2,3,1,1,1,1
20100,2020-10-12,"04,05,08,22,33","07,10",4,5,8,22,33,7,10,72,29,2,3,17,3,1,1,3,1,1,2,0
20101,2020-10-14,"03,04,05,09,34","07,09",3,4,5,9,34,7,9,55,31,3,2,16,2,2,0,4,0,1,2,0
20102,2020-10-17,"07,11,18,20,29","09,12",7,11,18,20,29,9,12,85,22,3,2,21,3,1,1,2,2,1,2,0
20103,2020-10-19,"07,12,13,19,23","02,08",7,12,13,19,23,2,8,74,16,4,1,10,6,0,2,2,3,0,1,1
20104,2020-10-21,"03,12,23,26,30","04,07",3,12,23,26,30,4,7,94,27,2,3,11,3,1,1,2,1,2,1,1
20105,2020-10-24,"03,08,12,13,22","04,12",3,8,12,13,22,4,12,58,19,2,3,16,8,0,2,3,2,0,1,1
20106,2020-10-26,"02,03,11,14,27","04,10",2,3,11,14,27,4,10,57,25,3,2,14,6,0,2,3,1,1,1,1
20107,2020-10-28,"01,04,13,17,28","03,07",1,4,13,17,28,3,7,63,27,3,2,10,4,2,0,2,2,1,1,1
20108,2020-10-31,"02,03,06,07,33","08,09",2,3,6,7,33,8,9,51,31,3,2,17,1,1,1,4,0,1,2,0
20109,2020-11-02,"02,20,21,23,32","06,12",2,20,21,23,32,6,12,98,30,2,3,18,6,0,2,1,3,1,1,1
20110,2020-11-04,"11,16,20,21,28","05,11",11,16,20,21,28,5,11,96,17,2,3,16,6,2,0,1,3,1,1,1
20111,2020-11-07,"05,07,09,20,28","02,07",5,7,9,20,28,2,7,69,23,3,2,9,5,1,1,3,1,1,1,1
20112,2020-11-09,"08,11,13,30,32","02,06",8,11,13,30,32,2,6,94,24,2,3,8,4,0,2,2,1,2,0,2
20113,2020-11-11,"06,14,18,28,33","02,05",6,14,18,28,33,2,5,99,27,1,4,7,3,1,1,1,2,2,0,2
20114,2020-11-14,"10,12,21,24,30","03,07",10,12,21,24,30,3,7,97,20,1,4,10,4,2,0,2,2,1,1,1
20115,2020-11-16,"01,09,18,19,23","01,09",1,9,18,19,23,1,9,70,22,4,1,10,8,2,0,2,3,0,1,1
20116,2020-11-18,"08,10,12,16,22","03,09",8,10,12,16,22,3,9,68,14,0,5,12,6,2,0,3,2,0,1,1
20117,2020-11-21,"07,19,20,23,24","05,10",7,19,20,23,24,5,10,93,17,3,2,15,5,1,1,1,4,0,1,1
20118,2020-11-23,"01,09,15,30,33","04,09",1,9,15,30,33,4,9,88,32,4,1,13,5,1,1,2,1,2,1,1
20119,2020-11-25,"14,22,24,28,32","07,08",14,22,24,28,32,7,8,120,18,0,5,15,1,1,1,0,3,2,2,0
20120,2020-11-28,"05,25,26,30,35","04,10",5,25,26,30,35,4,10,121,30,3,2,14,6,0,2,1,0,4,1,1
20121,2020-11-30,"09,17,27,28,35","03,08",9,17,27,28,35,3,8,116,26,4,1,11,5,1,1,1,1,3,1,1
20122,2020-12-02,"08,19,29,34,35","06,11",8,19,29,34,35,6,11,125,27,3,2,17,5,1,1,1,1,3,1,1
20123,2020-12-05,"01,07,11,15,21","04,11",1,7,11,15,21,4,11,55,20,5,0,15,7,1,1,3,2,0,1,1
20124,2020-12-07,"11,15,24,26,35","04,05",11,15,24,26,35,4,5,111,24,3,2,9,1,1,1,1,2,2,0,2
20125,2020-12-09,"01,02,03,08,22","01,04",1,2,3,8,22,1,4,36,21,2,3,5,3,1,1,4,1,0,0,2
20126,2020-12-12,"01,04,09,22,28","04,12",1,4,9,22,28,4,12,64,27,2,3,16,8,0,2,3,1,1,1,1
20127,2020-12-14,"01,04,17,18,26","03,10",1,4,17,18,26,3,10,66,25,2,3,13,7,1,1,2,2,1,1,1
20128,2020-12-16,"09,12,13,26,33","04,10",9,12,13,26,33,4,10,93,24,3,2,14,6,0,2,2,1,2,1,1
20129,2020-12-19,"10,22,27,33,34","01,11",10,22,27,33,34,1,11,126,24,2,3,12,10,2,0,1,1,3,1,1
20130,2020-12-21,"16,17,23,26,32","02,12",16,17,23,26,32,2,12,114,16,2,3,14,10,0,2,0,3,2,1,1
20131,2020-12-23,"08,25,27,29,35","02,03",8,25,27,29,35,2,3,124,27,4,1,5,1,1,1,1,0,4,0,2
20132,2020-12-26,"03,15,16,17,21","07,10",3,15,16,17,21,7,10,72,18,4,1,17,3,1,1,1,4,0,2,0
20133,2020-12-28,"11,24,26,33,35","08,09",11,24,26,33,35,8,9,129,24,3,2,17,1,1,1,1,1,3,2,0
20134,2020-12-30,"08,11,13,22,25","04,07",8,11,13,22,25,4,7,79,17,3,2,11,3,1,1,2,2,1,1,1
21001,2021-01-02,"02,06,12,19,33","08,09",2,6,12,19,33,8,9,72,31,2,3,17,1,1,1,3,1,1,2,0
21002,2021-01-04,"02,16,26,31,34","09,11",2,16,26,31,34,9,11,109,32,1,4,20,2,2,0,1,1,3,2,0
21003,2021-01-06,"07,21,28,31,35","04,10",7,21,28,31,35,4,10,122,28,4,1,14,6,0,2,1,1,3,1,1
21004,2021-01-09,"05,10,17,23,28","02,08",5,10,17,23,28,2,8,83,23,3,2,10,6,0,2,2,2,1,1,1
21005,2021-01-11,"03,07,10,12,35","03,05",3,7,10,12,35,3,5,67,32,3,2,8,2,2,0,4,0,1,0,2
21006,2021-01-13,"04,22,25,28,35","04,05",4,22,25,28,35,4,5,114,31,2,3,9,1,1,1,1,1,3,0,2
21007,2021-01-16,"05,23,30,34,35","08,10",5,23,30,34,35,8,10,127,30,3,2,18,2,0,2,1,1,3,2,0
21008,2021-01-18,"05,19,20,27,33","03,08",5,19,20,27,33,3,8,104,28,4,1,11,5,1,1,1,2,2,1,1
21009,2021-01-20,"01,03,20,29,32","05,12",1,3,20,29,32,5,12,85,31,3,2,17,7,1,1,2,1,2,1,1
21010,2021-01-23,"01,05,16,22,34","08,11",1,5,16,22,34,8,11,78,33,2,3,19,3,1,1,2,2,1,2,0
21011,2021-01-25,"06,09,11,14,21","01,03",6,9,11,14,21,1,3,61,15,3,2,4,2,2,0,3,2,0,0,2
21012,2021-01-27,"06,12,20,23,33","01,09",6,12,20,23,33,1,9,94,27,2,3,10,8,2,0,2,2,1,1,1
21013,2021-01-30,"21,27,28,30,34","08,11",21,27,28,30,34,8,11,140,13,2,3,19,3,1,1,0,1,4,2,0
21014,2021-02-01,"07,13,20,27,29","04,09",7,13,20,27,29,4,9,96,22,4,1,13,5,1,1,1,2,2,1,1
21015,2021-02-03,"04,08,17,19,25","01,07",4,8,17,19,25,1,7,73,21,3,2,8,6,2,0,2,2,1,1,1
21016,2021-02-06,"08,09,10,19,34","01,02",8,9,10,19,34,1,2,80,26,2,3,3,1,1,1,3,1,1,0,2
21017,2021-02-08,"17,21,26,29,32","02,07",17,21,26,29,32,2,7,125,15,3,2,9,5,1,1,0,2,3,1,1
21018,2021-02-20,"02,20,23,26,34","05,10",2,20,23,26,34,5,10,105,32,1,4,15,5,1,1,1,2,2,1,1
21019,2021-02-22,"01,12,13,28,29","03,04",1,12,13,28,29,3,4,83,28,3,2,7,1,1,1,2,1,2,0,2
21020,2021-02-24,"07,21,22,30,33","04,06",7,21,22,30,33,4,6,113,26,3,2,10,2,0,2,1,2,2,0,2
21021,2021-02-27,"16,18,29,33,35","09,12",16,18,29,33,35,9,12,131,19,3,2,21,3,1,1,0,2,3,2,0
21022,2021-03-01,"02,12,22,30,33","02,04",2,12,22,30,33,2,4,99,31,1,4,6,2,0,2,2,1,2,0,2
21023,2021-03-03,"07,09,13,16,32","02,09",7,9,13,16,32,2,9,77,25,3,2,11,7,1,1,2,2,1,1,1
21024,2021-03-06,"11,14,21,24,31","02,10",11,14,21,24,31,2,10,101,20,3,2,12,8,0,2,1,3,1,1,1
21025,2021-03-08,"17,18,23,30,31","10,12",17,18,23,30,31,10,12,119,14,3,2,22,2,0,2,0,3,2,2,0
21026,2021-03-10,"07,11,20,24,27","01,11",7,11,20,24,27,1,11,89,20,3,2,12,10,2,0,2,2,1,1,1
21027,2021-03-13,"09,21,22,26,30","04,12",9,21,22,26,30,4,12,108,21,2,3,16,8,0,2,1,2,2,1,1
21028,2021-03-15,"02,03,05,17,29","04,10",2,3,5,17,29,4,10,56,27,4,1,14,6,0,2,3,1,1,1,1
21029,2021-03-17,"02,06,10,32,33","04,07",2,6,10,32,33,4,7,83,31,1,4,11,3,1,1,3,0,2,1,1
21030,2021-03-20,"18,23,25,26,32","02,07",18,23,25,26,32,2,7,124,14,2,3,9,5,1,1,0,2,3,1,1
21031,2021-03-22,"01,04,19,20,34","03,05",1,4,19,20,34,3,5,78,33,2,3,8,2,2,0,2,2,1,0,2
21032,2021-03-24,"01,11,14,34,35","07,10",1,11,14,34,35,7,10,95,34,3,2,17,3,1,1,2,1,2,2,0
21033,2021-03-27,"01,03,05,30,32","01,05",1,3,5,30,32,1,5,71,31,3,2,6,4,2,0,3,0,2,0,2
21034,2021-03-29,"08,10,14,25,34","07,08",8,10,14,25,34,7,8,91,26,1,4,15,1,1,1,2,1,2,2,0
21035,2021-03-31,"05,11,16,30,32","03,04",5,11,16,30,32,3,4,94,27,2,3,7,1,1,1,2,1,2,0,2
21036,2021-04-03,"08,17,25,28,33","07,11",8,17,25,28,33,7,11,111,25,3,2,18,4,2,0,1,1,3,2,0
21037,2021-04-05,"10,21,27,29,33","04,12",10,21,27,29,33,4,12,120,23,4,1,16,8,0,2,1,1,3,1,1
21038,2021-04-07,"09,11,20,29,32","01,07",9,11,20,29,32,1,7,101,23,3,2,8,6,2,0,2,1,2,1,1
21039,2021-04-10,"04,12,14,21,35","02,11",4,12,14,21,35,2,11,86,31,2,3,13,9,1,1,2,2,1,1,1
21040,2021-04-12,"02,03,09,16,19","03,07",2,3,9,16,19,3,7,49,17,3,2,10,4,2,0,3,2,0,1,1
21041,2021-04-14,"02,05,09,11,32","04,09",2,5,9,11,32,4,9,59,30,3,2,13,5,1,1,4,0,1,1,1
21042,2021-04-17,"09,15,20,23,29","04,05",9,15,20,23,29,4,5,96,20,4,1,9,1,1,1,1,3,1,0,2
21043,2021-04-19,"07,12,17,19,34","01,10",7,12,17,19,34,1,10,89,27,3,2,11,9,1,1,2,2,1,1,1
21044,2021-04-21,"06,18,31,33,35","10,11",6,18,31,33,35,10,11,123,29,3,2,21,1,1,1,1,1,3,2,0
21045,2021-04-24,"01,04,06,11,19","07,09",1,4,6,11,19,7,9,41,18,3,2,16,2,2,0,4,1,0,2,0
21046,2021-04-26,"06,08,12,14,18","06,08",6,8,12,14,18,6,8,58,12,0,5,14,2,0,2,3,2,0,1,1
21047,2021-04-28,"01,06,09,25,33","04,08",1,6,9,25,33,4,8,74,32,4,1,12,4,0,2,3,0,2,1,1
21048,2021-05-01,"04,07,17,21,27","10,12",4,7,17,21,27,10,12,76,23,4,1,22,2,0,2,2,2,1,2,0
21049,2021-05-03,"01,10,22,23,25","02,12",1,10,22,23,25,2,12,81,24,3,2,14,10,0,2,2,2,1,1,1
21050,2021-05-05,"09,22,32,33,35","05,10",9,22,32,33,35,5,10,131,26,3,2,15,5,1,1,1,1,3,1,1
21051,2021-05-08,"01,04,14,16,19","03,04",1,4,14,16,19,3,4,54,18,2,3,7,1,1,1,2,3,0,0,2
21052,2021-05-10,"02,11,13,14,30","09,12",2,11,13,14,30,9,12,70,28,2,3,21,3,1,1,2,2,1,2,0
21053,2021-05-12,"03,06,15,17,35","07,11",3,6,15,17,35,7,11,76,32,4,1,18,4,2,0,2,2,1,2,0
21054,2021-05-15,"03,06,17,20,25","03,09",3,6,17,20,25,3,9,71,22,3,2,12,6,2,0,2,2,1,1,1
21055,2021-05-17,"03,06,10,11,24","10,11",3,6,10,11,24,10,11,54,21,2,3,21,1,1,1,4,1,0,2,0
21056,2021-05-19,"03,11,16,21,26","09,10",3,11,16,21,26,9,10,77,23,3,2,19,1,1,1,2,2,1,2,0
21057,2021-05-22,"05,07,19,20,28","05,07",5,7,19,20,28,5,7,79,23,3,2,12,2,2,0,2,2,1,1,1
21058,2021-05-24,"13,15,17,23,34","01,11",13,15,17,23,34,1,11,102,21,4,1,12,10,2,0,0,4,1,1,1
21059,2021-05-26,"04,16,27,28,35","02,09",4,16,27,28,35,2,9,110,31,2,3,11,7,1,1,1,1,3,1,1
21060,2021-05-29,"09,13,25,31,33","03,07",9,13,25,31,33,3,7,111,24,5,0,10,4,2,0,1,1,3,1,1
21061,2021-05-31,"15,19,20,26,32","04,07",15,19,20,26,32,4,7,112,17,2,3,11,3,1,1,0,3,2,1,1
21062,2021-06-02,"04,06,23,32,34","05,07",4,6,23,32,34,5,7,99,30,1,4,12,2,2,0,2,1,2,1,1
21063,2021-06-05,"05,09,14,29,30","09,11",5,9,14,29,30,9,11,87,25,3,2,20,2,2,0,2,1,2,2,0
21064,2021-06-07,"01,17,19,32,34","06,10",1,17,19,32,34,6,10,103,33,3,2,16,4,0,2,1,2,2,1,1
21065,2021-06-09,"23,25,30,31,35","07,08",23,25,30,31,35,7,8,144,12,4,1,15,1,1,1,0,1,4,2,0
21066,2021-06-12,"24,26,29,34,35","09,11",24,26,29,34,35,9,11,148,11,2,3,20,2,2,0,0,1,4,2,0
21067,2021-06-14,"01,04,22,23,34","08,09",1,4,22,23,34,8,9,84,33,2,3,17,1,1,1,2,2,1,2,0
21068,2021-06-16,"02,20,21,26,30","02,10",2,20,21,26,30,2,10,99,28,1,4,12,8,0,2,1,2,2,1,1
21069,2021-06-19,"01,03,24,32,33","04,06",1,3,24,32,33,4,6,93,32,3,2,10,2,0,2,2,1,2,0,2
21070,2021-06-21,"03,20,21,22,24","06,12",3,20,21,22,24,6,12,90,21,2,3,18,6,0,2,1,4,0,1,1
21071,2021-06-23,"08,11,16,29,35","01,04",8,11,16,29,35,1,4,99,27,3,2,5,3,1,1,2,1,2,0,2
21072,2021-06-26,"02,03,15,22,26","03,11",2,3,15,22,26,3,11,68,24,2,3,14,8,2,0,2,2,1,1,1
21073,2021-06-28,"08,12,14,20,24","06,10",8,12,14,20,24,6,10,78,16,0,5,16,4,0,2,2,3,0,1,1
21074,2021-06-30,"11,14,18,20,25","03,07",11,14,18,20,25,3,7,88,14,2,3,10,4,2,0,1,3,1,1,1
21075,2021-07-03,"06,14,15,17,20","01,05",6,14,15,17,20,1,5,72,14,2,3,6,4,2,0,1,4,0,0,2
21076,2021-07-05,"06,13,22,25,26","02,04",6,13,22,25,26,2,4,92,20,2,3,6,2,0,2,1,2,2,0,2
21077,2021-07-07,"02,06,09,21,25","06,08",2,6,9,21,25,6,8,63,23,3,2,14,2,0,2,3,1,1,1,1
21078,2021-07-10,"02,08,17,19,25","01,05",2,8,17,19,25,1,5,71,23,3,2,6,4,2,0,2,2,1,0,2
21079,2021-07-12,"06,14,19,26,33","08,11",6,14,19,26,33,8,11,98,27,2,3,19,3,1,1,1,2,2,2,0
21080,2021-07-14,"15,16,20,29,30","06,10",15,16,20,29,30,6,10,110,15,2,3,16,4,0,2,0,3,2,1,1
21081,2021-07-17,"05,13,24,29,35","07,08",5,13,24,29,35,7,8,106,30,4,1,15,1,1,1,1,2,2,2,0
21082,2021-07-19,"01,14,22,29,33","03,10",1,14,22,29,33,3,10,99,32,3,2,13,7,1,1,1,2,2,1,1
21083,2021-07-21,"07,09,11,26,35","01,08",7,9,11,26,35,1,8,88,28,4,1,9,7,1,1,3,0,2,1,1
21084,2021-07-24,"02,10,14,30,33","06,09",2,10,14,30,33,6,9,89,31,1,4,15,3,1,1,2,1,2,1,1
21085,2021-07-26,"01,12,15,26,35","10,11",1,12,15,26,35,10,11,89,34,3,2,21,1,1,1,2,1,2,2,0
21086,2021-07-28,"02,03,07,16,17","06,10",2,3,7,16,17,6,10,45,15,3,2,16,4,0,2,3,2,0,1,1
21087,2021-07-31,"10,14,15,25,28","03,10",10,14,15,25,28,3,10,92,18,2,3,13,7,1,1,1,2,2,1,1
21088,2021-08-02,"02,14,31,34,35","01,07",2,14,31,34,35,1,7,116,33,2,3,8,6,2,0,1,1,3,1,1
21089,2021-08-04,"01,17,24,28,35","10,12",1,17,24,28,35,10,12,105,34,3,2,22,2,0,2,1,2,2,2,0
21090,2021-08-07,"06,07,19,26,32","06,12",6,7,19,26,32,6,12,90,26,2,3,18,6,0,2,2,1,2,1,1
21091,2021-08-09,"01,04,10,21,29","03,05",1,4,10,21,29,3,5,65,28,3,2,8,2,2,0,3,1,1,0,2
21092,2021-08-11,"12,14,27,28,34","03,07",12,14,27,28,34,3,7,115,22,1,4,10,4,2,0,1,1,3,1,1
21093,2021-08-14,"20,25,27,28,31","08,11",20,25,27,28,31,8,11,131,11,3,2,19,3,1,1,0,1,4,2,0
21094,2021-08-16,"05,06,24,27,33","05,12",5,6,24,27,33,5,12,95,28,3,2,17,7,1,1,2,1,2,1,1
21095,2021-08-18,"10,15,19,20,30","11,12",10,15,19,20,30,11,12,94,20,2,3,23,1,1,1,1,3,1,2,0
21096,2021-08-21,"07,08,10,20,21","01,05",7,8,10,20,21,1,5,66,14,2,3,6,4,2,0,3,2,0,0,2
21097,2021-08-23,"11,26,30,31,33","03,10",11,26,30,31,33,3,10,131,22,3,2,13,7,1,1,1,0,4,1,1
21098,2021-08-25,"02,07,21,27,33","07,09",2,7,21,27,33,7,9,90,31,4,1,16,2,2,0,2,1,2,2,0
21099,2021-08-28,"15,19,27,28,30","03,04",15,19,27,28,30,3,4,119,15,3,2,7,1,1,1,0,2,3,0,2
21100,2021-08-30,"07,11,23,26,28","02,07",7,11,23,26,28,2,7,95,21,3,2,9,5,1,1,2,1,2,1,1
21101,2021-09-01,"13,18,19,27,32","06,11",13,18,19,27,32,6,11,109,19,3,2,17,5,1,1,0,3,2,1,1
21102,2021-09-04,"02,08,11,16,23","02,07",2,8,11,16,23,2,7,60,21,2,3,9,5,1,1,3,2,0,1,1
21103,2021-09-06,"04,10,23,30,31","05,11",4,10,23,30,31,5,11,98,27,2,3,16,6,2,0,2,1,2,1,1
21104,2021-09-08,"23,25,26,30,33","03,11",23,25,26,30,33,3,11,137,10,3,2,14,8,2,0,0,1,4,1,1
21105,2021-09-11,"07,10,11,17,18","04,09",7,10,11,17,18,4,9,63,11,3,2,13,5,1,1,3,2,0,1,1
21106,2021-09-13,"02,13,14,32,34","02,12",2,13,14,32,34,2,12,95,32,1,4,14,10,0,2,1,2,2,1,1
21107,2021-09-15,"03,05,13,20,25","07,11",3,5,13,20,25,7,11,66,22,4,1,18,4,2,0,2,2,1,2,0
21108,2021-09-18,"05,19,22,26,35","02,06",5,19,22,26,35,2,6,107,30,3,2,8,4,0,2,1,2,2,0,2
21109,2021-09-20,"03,04,07,27,31","06,09",3,4,7,27,31,6,9,72,28,4,1,15,3,1,1,3,0,2,1,1
21110,2021-09-22,"11,14,29,31,32","11,12",11,14,29,31,32,11,12,117,21,3,2,23,1,1,1,1,1,3,2,0
21111,2021-09-25,"07,08,15,19,28","08,09",7,8,15,19,28,8,9,77,21,3,2,17,1,1,1,2,2,1,2,0
21112,2021-09-27,"18,21,22,23,35","11,12",18,21,22,23,35,11,12,119,17,3,2,23,1,1,1,0,4,1,2,0
21113,2021-09-29,"17,18,25,27,28","04,08",17,18,25,27,28,4,8,115,11,3,2,12,4,0,2,0,2,3,1,1
21114,2021-10-06,"08,09,13,29,30","01,11",8,9,13,29,30,1,11,89,22,3,2,12,10,2,0,2,1,2,1,1
21115,2021-10-09,"08,13,19,20,29","06,10",8,13,19,20,29,6,10,89,21,3,2,16,4,0,2,1,3,1,1,1
21116,2021-10-11,"04,25,28,29,35","03,11",4,25,28,29,35,3,11,121,31,3,2,14,8,2,0,1,0,4,1,1
21117,2021-10-13,"11,18,21,22,33","05,06",11,18,21,22,33,5,6,105,22,3,2,11,1,1,1,1,3,1,0,2
21118,2021-10-16,"14,17,18,28,34","02,03",14,17,18,28,34,2,3,111,20,1,4,5,1,1,1,0,3,2,0,2
21119,2021-10-18,"01,02,09,16,30","09,10",1,2,9,16,30,9,10,58,29,2,3,19,1,1,1,3,1,1,2,0
21120,2021-10-20,"05,10,21,25,31","05,11",5,10,21,25,31,5,11,92,26,4,1,16,6,2,0,2,1,2,1,1
21121,2021-10-23,"02,15,19,29,30","02,09",2,15,19,29,30,2,9,95,28,3,2,11,7,1,1,1,2,2,1,1
21122,2021-10-25,"14,15,26,27,29","04,05",14,15,26,27,29,4,5,111,15,3,2,9,1,1,1,0,2,3,0,2
21123,2021-10-27,"08,23,26,27,33","08,09",8,23,26,27,33,8,9,117,25,3,2,17,1,1,1,1,1,3,2,0
21124,2021-10-30,"10,17,22,25,35","07,09",10,17,22,25,35,7,9,109,25,3,2,16,2,2,0,1,2,2,2,0
21125,2021-11-01,"17,19,21,27,31","04,09",17,19,21,27,31,4,9,115,14,5,0,13,5,1,1,0,3,2,1,1
21126,2021-11-03,"01,11,12,34,35","09,12",1,11,12,34,35,9,12,93,34,3,2,21,3,1,1,3,0,2,2,0
21127,2021-11-06,"01,02,15,17,26","02,11",1,2,15,17,26,2,11,61,25,3,2,13,9,1,1,2,2,1,1,1
21128,2021-11-08,"14,17,18,23,27","05,08",14,17,18,23,27,5,8,99,13,3,2,13,3,1,1,0,4,1,1,1
21129,2021-11-10,"02,16,17,18,34","04,10",2,16,17,18,34,4,10,87,32,1,4,14,6,0,2,1,3,1,1,1
21130,2021-11-13,"02,03,14,27,28","05,10",2,3,14,27,28,5,10,74,26,2,3,15,5,1,1,2,1,2,1,1
21131,2021-11-15,"06,08,16,34,35","05,06",6,8,16,34,35,5,6,99,29,1,4,11,1,1,1,2,1,2,0,2
21132,2021-11-17,"04,21,28,29,33","03,11",4,21,28,29,33,3,11,115,29,3,2,14,8,2,0,1,1,3,1,1
21133,2021-11-20,"08,09,17,26,28","06,08",8,9,17,26,28,6,8,88,20,2,3,14,2,0,2,2,1,2,1,1
21134,2021-11-22,"02,06,14,19,28","01,06",2,6,14,19,28,1,6,69,26,1,4,7,5,1,1,2,2,1,0,2
21135,2021-11-24,"04,07,17,29,31","05,06",4,7,17,29,31,5,6,88,27,4,1,11,1,1,1,2,1,2,0,2
21136,2021-11-27,"08,12,19,27,33","02,05",8,12,19,27,33,2,5,99,25,3,2,7,3,1,1,2,1,2,0,2
21137,2021-11-29,"02,07,13,14,19","04,05",2,7,13,14,19,4,5,55,17,3,2,9,1,1,1,2,3,0,0,2
21138,2021-12-01,"09,11,12,15,31","05,11",9,11,12,15,31,5,11,78,22,4,1,16,6,2,0,3,1,1,1,1
21139,2021-12-04,"05,13,18,23,34","08,09",5,13,18,23,34,8,9,93,29,3,2,17,1,1,1,1,3,1,2,0
21140,2021-12-06,"05,24,26,33,35","09,12",5,24,26,33,35,9,12,123,30,3,2,21,3,1,1,1,1,3,2,0
21141,2021-12-08,"02,08,16,29,34","05,12",2,8,16,29,34,5,12,89,32,1,4,17,7,1,1,2,1,2,1,1
21142,2021-12-11,"11,13,17,19,25","02,09",11,13,17,19,25,2,9,85,14,5,0,11,7,1,1,1,3,1,1,1
21143,2021-12-13,"09,17,19,29,34","04,11",9,17,19,29,34,4,11,108,25,4,1,15,7,1,1,1,2,2,1,1
21144,2021-12-15,"03,20,25,30,34","02,09",3,20,25,30,34,2,9,112,31,2,3,11,7,1,1,1,1,3,1,1
21145,2021-12-18,"03,08,25,29,30","01,06",3,8,25,29,30,1,6,95,27,3,2,7,5,1,1,2,0,3,0,2
21146,2021-12-20,"03,05,08,18,20","09,11",3,5,8,18,20,9,11,54,17,2,3,20,2,2,0,3,2,0,2,0
21147,2021-12-22,"01,02,08,12,26","01,07",1,2,8,12,26,1,7,49,25,1,4,8,6,2,0,4,0,1,1,1
21148,2021-12-25,"01,04,12,16,29","04,08",1,4,12,16,29,4,8,62,28,2,3,12,4,0,2,3,1,1,1,1
21149,2021-12-27,"20,26,28,30,35","10,11",20,26,28,30,35,10,11,139,15,1,4,21,1,1,1,0,1,4,2,0
21150,2021-12-29,"04,10,11,23,26","07,10",4,10,11,23,26,7,10,74,22,2,3,17,3,1,1,3,1,1,2,0
22001,2022-01-01,"08,11,19,22,29","03,11",8,11,19,22,29,3,11,89,21,3,2,14,8,2,0,2,2,1,1,1
22002,2022-01-03,"04,06,07,09,24","04,12",4,6,7,9,24,4,12,50,20,2,3,16,8,0,2,4,1,0,1,1
22003,2022-01-05,"02,18,24,25,34","08,12",2,18,24,25,34,8,12,103,32,1,4,20,4,0,2,1,2,2,2,0
22004,2022-01-08,"07,20,27,30,33","03,04",7,20,27,30,33,3,4,117,26,3,2,7,1,1,1,1,1,3,0,2
22005,2022-01-10,"02,13,17,19,34","05,09",2,13,17,19,34,5,9,85,32,3,2,14,4,2,0,1,3,1,1,1
22006,2022-01-12,"01,05,07,17,20","05,12",1,5,7,17,20,5,12,50,19,4,1,17,7,1,1,3,2,0,1,1
22007,2022-01-15,"05,22,23,25,35","03,11",5,22,23,25,35,3,11,110,30,4,1,14,8,2,0,1,2,2,1,1
22008,2022-01-17,"01,02,13,18,34","06,07",1,2,13,18,34,6,7,68,33,2,3,13,1,1,1,2,2,1,1,1
22009,2022-01-19,"13,14,18,31,33","07,10",13,14,18,31,33,7,10,109,20,3,2,17,3,1,1,0,3,2,2,0
22010,2022-01-22,"04,19,25,31,35","02,11",4,19,25,31,35,2,11,114,31,4,1,13,9,1,1,1,1,3,1,1
22011,2022-01-24,"03,05,17,24,32","05,12",3,5,17,24,32,5,12,81,29,3,2,17,7,1,1,2,2,1,1,1
22012,2022-01-26,"03,05,10,33,34","07,10",3,5,10,33,34,7,10,85,31,3,2,17,3,1,1,3,0,2,2,0
22013,2022-02-09,"04,09,16,25,32","05,06",4,9,16,25,32,5,6,86,28,2,3,11,1,1,1,2,1,2,0,2
22014,2022-02-12,"01,04,10,18,32","01,09",1,4,10,18,32,1,9,65,31,1,4,10,8,2,0,3,1,1,1,1
22015,2022-02-14,"01,02,08,12,30","05,12",1,2,8,12,30,5,12,53,29,1,4,17,7,1,1,4,0,1,1,1
22016,2022-02-16,"01,07,17,26,32","01,09",1,7,17,26,32,1,9,83,31,3,2,10,8,2,0,2,1,2,1,1
22017,2022-02-19,"10,14,18,23,25","07,11",10,14,18,23,25,7,11,90,15,2,3,18,4,2,0,1,3,1,2,0
22018,2022-02-21,"16,21,29,31,34","06,09",16,21,29,31,34,6,9,131,18,3,2,15,3,1,1,0,2,3,1,1
22019,2022-02-23,"01,04,07,17,21","01,02",1,4,7,17,21,1,2,50,20,4,1,3,1,1,1,3,2,0,0,2
22020,2022-02-26,"16,17,30,31,35","08,09",16,17,30,31,35,8,9,129,19,3,2,17,1,1,1,0,2,3,2,0
22021,2022-02-28,"11,15,16,18,35","06,09",11,15,16,18,35,6,9,95,24,3,2,15,3,1,1,1,3,1,1,1
22022,2022-03-02,"01,05,14,17,28","06,07",1,5,14,17,28,6,7,65,27,3,2,13,1,1,1,2,2,1,1,1
22023,2022-03-05,"04,05,18,20,25","11,12",4,5,18,20,25,11,12,72,21,2,3,23,1,1,1,2,2,1,2,0
22024,2022-03-07,"01,02,11,30,35","01,12",1,2,11,30,35,1,12,79,34,3,2,13,11,1,1,3,0,2,1,1
22025,2022-03-09,"04,07,22,24,29","01,07",4,7,22,24,29,1,7,86,25,2,3,8,6,2,0,2,2,1,1,1
22026,2022-03-12,"11,14,22,23,27","08,10",11,14,22,23,27,8,10,97,16,3,2,18,2,0,2,1,3,1,2,0
22027,2022-03-14,"03,06,11,31,32","05,12",3,6,11,31,32,5,12,83,29,3,2,17,7,1,1,3,0,2,1,1
22028,2022-03-16,"04,09,16,17,35","01,07",4,9,16,17,35,1,7,81,31,3,2,8,6,2,0,2,2,1,1,1
22029,2022-03-19,"07,08,10,14,17","10,12",7,8,10,14,17,10,12,56,10,2,3,22,2,0,2,3,2,0,2,0
22030,2022-03-21,"12,14,15,21,30","01,09",12,14,15,21,30,1,9,92,18,2,3,10,8,2,0,1,3,1,1,1
22031,2022-03-23,"07,14,16,20,28","04,08",7,14,16,20,28,4,8,85,21,1,4,12,4,0,2,1,3,1,1,1
22032,2022-03-26,"05,09,18,31,32","01,05",5,9,18,31,32,1,5,95,27,3,2,6,4,2,0,2,1,2,0,2
22033,2022-03-28,"08,15,16,19,33","03,04",8,15,16,19,33,3,4,91,25,3,2,7,1,1,1,1,3,1,0,2
22034,2022-03-30,"02,10,24,27,28","06,07",2,10,24,27,28,6,7,91,26,1,4,13,1,1,1,2,1,2,1,1
22035,2022-04-02,"09,11,13,23,31","05,08",9,11,13,23,31,5,8,87,22,5,0,13,3,1,1,2,2,1,1,1
22036,2022-04-04,"18,19,21,26,34","06,07",18,19,21,26,34,6,7,118,16,2,3,13,1,1,1,0,3,2,1,1
22037,2022-04-06,"01,09,17,20,28","06,10",1,9,17,20,28,6,10,75,27,3,2,16,4,0,2,2,2,1,1,1
22038,2022-04-09,"07,09,11,12,26","09,12",7,9,11,12,26,9,12,65,19,3,2,21,3,1,1,4,0,1,2,0
22039,2022-04-11,"01,08,11,22,31","05,11",1,8,11,22,31,5,11,73,30,3,2,16,6,2,0,3,1,1,1,1
22040,2022-04-13,"10,19,25,29,33","08,12",10,19,25,29,33,8,12,116,23,4,1,20,4,0,2,1,1,3,2,0
22041,2022-04-16,"05,15,25,26,33","06,11",5,15,25,26,33,6,11,104,28,4,1,17,5,1,1,1,1,3,1,1
22042,2022-04-18,"08,10,11,29,32","02,06",8,10,11,29,32,2,6,90,24,2,3,8,4,0,2,3,0,2,0,2
22043,2022-04-20,"02,16,17,24,30","09,12",2,16,17,24,30,9,12,89,28,1,4,21,3,1,1,1,3,1,2,0
22044,2022-04-23,"01,02,16,17,20","03,07",1,2,16,17,20,3,7,56,19,2,3,10,4,2,0,2,3,0,1,1
22045,2022-04-25,"02,03,07,12,20","01,05",2,3,7,12,20,1,5,44,18,2,3,6,4,2,0,4,1,0,0,2
22046,2022-04-27,"06,07,12,22,27","03,05",6,7,12,22,27,3,5,74,21,2,3,8,2,2,0,3,1,1,0,2
22047,2022-04-30,"07,10,11,12,33","03,11",7,10,11,12,33,3,11,73,26,3,2,14,8,2,0,4,0,1,1,1
22048,2022-05-02,"16,22,28,29,32","08,09",16,22,28,29,32,8,9,127,16,1,4,17,1,1,1,0,2,3,2,0
22049,2022-05-04,"06,10,20,28,35","01,10",6,10,20,28,35,1,10,99,29,1,4,11,9,1,1,2,1,2,1,1
22050,2022-05-07,"02,10,21,24,30","08,10",2,10,21,24,30,8,10,87,28,1,4,18,2,0,2,2,2,1,2,0
22051,2022-05-09,"01,16,17,19,33","05,06",1,16,17,19,33,5,6,86,32,4,1,11,1,1,1,1,3,1,0,2
22052,2022-05-11,"01,13,18,29,35","04,09",1,13,18,29,35,4,9,96,34,4,1,13,5,1,1,1,2,2,1,1
22053,2022-05-14,"09,17,19,20,25","01,09",9,17,19,20,25,1,9,90,16,4,1,10,8,2,0,1,3,1,1,1
22054,2022-05-16,"05,16,21,23,34","07,10",5,16,21,23,34,7,10,99,29,3,2,17,3,1,1,1,3,1,2,0
22055,2022-05-18,"01,02,12,15,23","04,06",1,2,12,15,23,4,6,53,22,3,2,10,2,0,2,3,2,0,0,2
22056,2022-05-21,"02,11,15,17,31","07,09",2,11,15,17,31,7,9,76,29,4,1,16,2,2,0,2,2,1,2,0
22057,2022-05-23,"06,12,18,21,35","07,10",6,12,18,21,35,7,10,92,29,2,3,17,3,1,1,2,2,1,2,0
22058,2022-05-25,"03,04,24,26,35","07,08",3,4,24,26,35,7,8,92,32,2,3,15,1,1,1,2,1,2,2,0
22059,2022-05-28,"04,15,18,32,34","04,09",4,15,18,32,34,4,9,103,30,1,4,13,5,1,1,1,2,2,1,1
22060,2022-05-30,"02,06,10,11,20","03,09",2,6,10,11,20,3,9,49,18,1,4,12,6,2,0,4,1,0,1,1
22061,2022-06-01,"06,09,19,22,30","01,06",6,9,19,22,30,1,6,86,24,2,3,7,5,1,1,2,2,1,0,2
22062,2022-06-04,"05,09,11,12,31","07,11",5,9,11,12,31,7,11,68,26,4,1,18,4,2,0,4,0,1,2,0
22063,2022-06-06,"02,03,22,26,31","06,10",2,3,22,26,31,6,10,84,29,2,3,16,4,0,2,2,1,2,1,1
22064,2022-06-08,"02,19,22,25,35","05,07",2,19,22,25,35,5,7,103,33,3,2,12,2,2,0,1,2,2,1,1
22065,2022-06-11,"05,10,13,22,28","01,04",5,10,13,22,28,1,4,78,23,2,3,5,3,1,1,2,2,1,0,2
22066,2022-06-13,"02,24,25,26,34","03,12",2,24,25,26,34,3,12,111,32,1,4,15,9,1,1,1,1,3,1,1
22067,2022-06-15,"04,14,15,32,33","10,11",4,14,15,32,33,10,11,98,29,2,3,21,1,1,1,1,2,2,2,0
22068,2022-06-18,"03,06,10,15,23","03,08",3,6,10,15,23,3,8,57,20,3,2,11,5,1,1,3,2,0,1,1
22069,2022-06-20,"02,03,23,28,35","02,09",2,3,23,28,35,2,9,91,33,3,2,11,7,1,1,2,1,2,1,1
22070,2022-06-22,"01,07,17,23,35","07,11",1,7,17,23,35,7,11,83,34,5,0,18,4,2,0,2,2,1,2,0
22071,2022-06-25,"09,15,19,25,29","08,09",9,15,19,25,29,8,9,97,20,5,0,17,1,1,1,1,2,2,2,0
22072,2022-06-27,"01,12,13,15,30","03,07",1,12,13,15,30,3,7,71,29,3,2,10,4,2,0,2,2,1,1,1
22073,2022-06-29,"11,18,21,25,32","02,04",11,18,21,25,32,2,4,107,21,3,2,6,2,0,2,1,2,2,0,2
22074,2022-07-02,"02,06,21,25,28","02,06",2,6,21,25,28,2,6,82,26,2,3,8,4,0,2,2,1,2,0,2
22075,2022-07-04,"04,12,13,17,18","07,09",4,12,13,17,18,7,9,64,14,2,3,16,2,2,0,2,3,0,2,0
22076,2022-07-06,"05,17,30,34,35","02,09",5,17,30,34,35,2,9,121,30,3,2,11,7,1,1,1,1,3,1,1
22077,2022-07-09,"05,10,11,16,19","01,10",5,10,11,16,19,1,10,61,14,3,2,11,9,1,1,3,2,0,1,1
22078,2022-07-11,"02,03,18,20,27","01,02",2,3,18,20,27,1,2,70,25,2,3,3,1,1,1,2,2,1,0,2
22079,2022-07-13,"07,10,19,26,32","08,12",7,10,19,26,32,8,12,94,25,2,3,20,4,0,2,2,1,2,2,0
22080,2022-07-16,"10,17,30,31,34","03,06",10,17,30,31,34,3,6,122,24,2,3,9,3,1,1,1,1,3,0,2
22081,2022-07-18,"05,10,19,31,32","09,10",5,10,19,31,32,9,10,97,27,3,2,19,1,1,1,2,1,2,2,0
22082,2022-07-20,"04,26,27,30,33","02,09",4,26,27,30,33,2,9,120,29,2,3,11,7,1,1,1,0,4,1,1
22083,2022-07-23,"02,09,17,26,32","04,06",2,9,17,26,32,4,6,86,30,2,3,10,2,0,2,2,1,2,0,2
22084,2022-07-25,"03,11,19,25,27","04,12",3,11,19,25,27,4,12,85,24,5,0,16,8,0,2,2,1,2,1,1
22085,2022-07-27,"11,16,31,33,35","06,08",11,16,31,33,35,6,8,126,24,4,1,14,2,0,2,1,1,3,1,1
22086,2022-07-30,"04,10,21,28,31","08,11",4,10,21,28,31,8,11,94,27,2,3,19,3,1,1,2,1,2,2,0
22087,2022-08-01,"04,06,10,24,28","06,12",4,6,10,24,28,6,12,72,24,0,5,18,6,0,2,3,1,1,1,1
22088,2022-08-03,"01,08,10,20,35","06,11",1,8,10,20,35,6,11,74,34,2,3,17,5,1,1,3,1,1,1,1
22089,2022-08-06,"01,20,21,31,33","03,11",1,20,21,31,33,3,11,106,32,4,1,14,8,2,0,1,2,2,1,1
22090,2022-08-08,"01,20,24,25,31","09,12",1,20,24,25,31,9,12,101,30,3,2,21,3,1,1,1,2,2,2,0
22091,2022-08-10,"02,11,20,22,34","04,12",2,11,20,22,34,4,12,89,32,1,4,16,8,0,2,2,2,1,1,1
22092,2022-08-13,"01,04,12,23,29","05,12",1,4,12,23,29,5,12,69,28,3,2,17,7,1,1,3,1,1,1,1
22093,2022-08-15,"07,11,14,21,29","07,10",7,11,14,21,29,7,10,82,22,4,1,17,3,1,1,2,2,1,2,0
22094,2022-08-17,"03,04,07,12,19","02,05",3,4,7,12,19,2,5,45,16,3,2,7,3,1,1,4,1,0,0,2
22095,2022-08-20,"05,08,22,25,35","02,07",5,8,22,25,35,2,7,95,30,3,2,9,5,1,1,2,1,2,1,1
22096,2022-08-22,"16,19,24,27,33","01,06",16,19,24,27,33,1,6,119,17,3,2,7,5,1,1,0,3,2,0,2
22097,2022-08-24,"05,13,22,28,29","05,11",5,13,22,28,29,5,11,97,24,3,2,16,6,2,0,1,2,2,1,1
22098,2022-08-27,"01,03,06,11,13","03,11",1,3,6,11,13,3,11,34,12,4,1,14,8,2,0,4,1,0,1,1
22099,2022-08-29,"07,18,25,27,33","04,05",7,18,25,27,33,4,5,110,26,4,1,9,1,1,1,1,1,3,0,2
22100,2022-08-31,"10,19,20,23,31","03,07",10,19,20,23,31,3,7,103,21,3,2,10,4,2,0,1,3,1,1,1
22101,2022-09-03,"02,04,06,07,08","03,06",2,4,6,7,8,3,6,27,6,1,4,9,3,1,1,5,0,0,0,2
22102,2022-09-05,"01,05,14,20,30","02,04",1,5,14,20,30,2,4,70,29,2,3,6,2,0,2,2,2,1,0,2
22103,2022-09-07,"08,12,16,21,32","01,12",8,12,16,21,32,1,12,89,24,1,4,13,11,1,1,2,2,1,1,1
22104,2022-09-10,"03,05,13,19,25","02,05",3,5,13,19,25,2,5,65,22,5,0,7,3,1,1,2,2,1,0,2
22105,2022-09-12,"01,08,09,21,22","01,04",1,8,9,21,22,1,4,61,21,3,2,5,3,1,1,3,2,0,0,2
22106,2022-09-14,"16,17,21,28,32","04,07",16,17,21,28,32,4,7,114,16,2,3,11,3,1,1,0,3,2,1,1
22107,2022-09-17,"07,09,19,28,29","08,10",7,9,19,28,29,8,10,92,22,4,1,18,2,0,2,2,1,2,2,0
22108,2022-09-19,"04,07,13,26,28","07,11",4,7,13,26,28,7,11,78,24,2,3,18,4,2,0,2,1,2,2,0
22109,2022-09-21,"05,09,24,29,35","05,12",5,9,24,29,35,5,12,102,30,4,1,17,7,1,1,2,1,2,1,1
22110,2022-09-24,"02,13,16,18,23","03,06",2,13,16,18,23,3,6,72,21,2,3,9,3,1,1,1,4,0,0,2
22111,2022-09-26,"06,12,16,19,31","06,10",6,12,16,19,31,6,10,84,25,2,3,16,4,0,2,2,2,1,1,1
22112,2022-09-28,"04,11,18,20,26","06,12",4,11,18,20,26,6,12,79,22,1,4,18,6,0,2,2,2,1,1,1
22113,2022-10-05,"13,15,22,31,33","05,12",13,15,22,31,33,5,12,114,20,4,1,17,7,1,1,0,3,2,1,1
22114,2022-10-08,"11,21,24,27,28","05,10",11,21,24,27,28,5,10,111,17,3,2,15,5,1,1,1,2,2,1,1
22115,2022-10-10,"17,19,20,23,27","03,08",17,19,20,23,27,3,8,106,10,4,1,11,5,1,1,0,4,1,1,1
22116,2022-10-12,"01,07,20,22,31","07,12",1,7,20,22,31,7,12,81,30,3,2,19,5,1,1,2,2,1,2,0
22117,2022-10-15,"09,12,15,21,32","02,07",9,12,15,21,32,2,7,89,23,3,2,9,5,1,1,2,2,1,1,1
22118,2022-10-17,"02,05,15,17,26","02,08",2,5,15,17,26,2,8,65,24,3,2,10,6,0,2,2,2,1,1,1
22119,2022-10-19,"01,09,16,25,29","04,09",1,9,16,25,29,4,9,80,28,4,1,13,5,1,1,2,1,2,1,1
22120,2022-10-22,"11,22,26,30,33","03,05",11,22,26,30,33,3,5,122,22,2,3,8,2,2,0,1,1,3,0,2
22121,2022-10-24,"04,15,16,20,21","04,05",4,15,16,20,21,4,5,76,17,2,3,9,1,1,1,1,4,0,0,2
22122,2022-10-26,"04,15,17,19,25","06,12",4,15,17,19,25,6,12,80,21,4,1,18,6,0,2,1,3,1,1,1
22123,2022-10-29,"02,20,28,29,30","07,10",2,20,28,29,30,7,10,109,28,1,4,17,3,1,1,1,1,3,2,0
22124,2022-10-31,"02,04,11,25,30","06,12",2,4,11,25,30,6,12,72,28,2,3,18,6,0,2,3,0,2,1,1
22125,2022-11-02,"03,07,14,16,19","01,11",3,7,14,16,19,1,11,59,16,3,2,12,10,2,0,2,3,0,1,1
22126,2022-11-05,"04,05,08,22,35","01,03",4,5,8,22,35,1,3,74,31,2,3,4,2,2,0,3,1,1,0,2
22127,2022-11-07,"02,03,08,09,20","04,10",2,3,8,9,20,4,10,42,18,2,3,14,6,0,2,4,1,0,1,1
22128,2022-11-09,"10,19,21,23,35","04,10",10,19,21,23,35,4,10,108,25,4,1,14,6,0,2,1,3,1,1,1
22129,2022-11-12,"10,17,23,34,35","01,04",10,17,23,34,35,1,4,119,25,3,2,5,3,1,1,1,2,2,0,2
22130,2022-11-14,"05,07,15,18,23","05,10",5,7,15,18,23,5,10,68,18,4,1,15,5,1,1,2,3,0,1,1
22131,2022-11-16,"02,06,08,10,17","05,06",2,6,8,10,17,5,6,43,15,1,4,11,1,1,1,4,1,0,0,2
22132,2022-11-19,"02,27,30,34,35","09,12",2,27,30,34,35,9,12,128,33,2,3,21,3,1,1,1,0,4,2,0
22133,2022-11-21,"01,02,14,30,31","06,09",1,2,14,30,31,6,9,78,30,2,3,15,3,1,1,2,1,2,1,1
22134,2022-11-23,"03,16,23,27,32","03,06",3,16,23,27,32,3,6,101,29,3,2,9,3,1,1,1,2,2,0,2
22135,2022-11-26,"09,10,27,31,32","01,03",9,10,27,31,32,1,3,109,23,3,2,4,2,2,0,2,0,3,0,2
22136,2022-11-28,"01,11,15,17,33","03,11",1,11,15,17,33,3,11,77,32,5,0,14,8,2,0,2,2,1,1,1
22137,2022-11-30,"05,06,08,15,20","07,08",5,6,8,15,20,7,8,54,15,2,3,15,1,1,1,3,2,0,2,0
22138,2022-12-03,"05,13,16,27,33","07,12",5,13,16,27,33,7,12,94,28,4,1,19,5,1,1,1,2,2,2,0
22139,2022-12-05,"01,13,14,22,35","02,05",1,13,14,22,35,2,5,85,34,3,2,7,3,1,1,1,3,1,0,2
22140,2022-12-07,"05,15,25,26,29","04,12",5,15,25,26,29,4,12,100,24,4,1,16,8,0,2,1,1,3,1,1
22141,2022-12-10,"05,06,14,24,25","02,04",5,6,14,24,25,2,4,74,20,2,3,6,2,0,2,2,2,1,0,2
22142,2022-12-12,"07,12,14,29,35","01,11",7,12,14,29,35,1,11,97,28,3,2,12,10,2,0,2,1,2,1,1
22143,2022-12-14,"10,13,14,27,33","07,08",10,13,14,27,33,7,8,97,23,3,2,15,1,1,1,1,2,2,2,0
22144,2022-12-17,"03,04,08,15,21","04,07",3,4,8,15,21,4,7,51,18,3,2,11,3,1,1,3,2,0,1,1
22145,2022-12-19,"10,20,29,30,35","06,09",10,20,29,30,35,6,9,124,25,2,3,15,3,1,1,1,1,3,1,1
22146,2022-12-21,"01,21,23,28,35","07,09",1,21,23,28,35,7,9,108,34,4,1,16,2,2,0,1,2,2,2,0
22147,2022-12-24,"04,12,22,28,30","09,11",4,12,22,28,30,9,11,96,26,0,5,20,2,2,0,2,1,2,2,0
22148,2022-12-26,"04,05,06,26,27","07,12",4,5,6,26,27,7,12,68,23,2,3,19,5,1,1,3,0,2,2,0
22149,2022-12-28,"15,19,22,26,28","02,07",15,19,22,26,28,2,7,110,13,2,3,9,5,1,1,0,3,2,1,1
22150,2022-12-31,"06,07,26,29,30","03,12",6,7,26,29,30,3,12,98,24,2,3,15,9,1,1,2,0,3,1,1
23001,2023-01-02,"18,19,24,27,34","11,12",18,19,24,27,34,11,12,122,16,2,3,23,1,1,1,0,3,2,2,0
23002,2023-01-04,"11,14,21,26,27","02,07",11,14,21,26,27,2,7,99,16,3,2,9,5,1,1,1,2,2,1,1
23003,2023-01-07,"05,06,14,21,22","02,09",5,6,14,21,22,2,9,68,17,2,3,11,7,1,1,2,3,0,1,1
23004,2023-01-09,"04,13,15,20,22","04,08",4,13,15,20,22,4,8,74,18,2,3,12,4,0,2,1,4,0,1,1
23005,2023-01-11,"01,03,10,20,29","06,11",1,3,10,20,29,6,11,63,28,3,2,17,5,1,1,3,1,1,1,1
23006,2023-01-14,"02,04,12,27,35","06,07",2,4,12,27,35,6,7,80,33,2,3,13,1,1,1,3,0,2,1,1
23007,2023-01-16,"02,03,24,30,32","01,06",2,3,24,30,32,1,6,91,30,1,4,7,5,1,1,2,1,2,0,2
23008,2023-01-18,"04,09,17,22,25","01,05",4,9,17,22,25,1,5,77,21,3,2,6,4,2,0,2,2,1,0,2
23009,2023-01-30,"01,05,11,15,33","01,10",1,5,11,15,33,1,10,65,32,5,0,11,9,1,1,3,1,1,1,1
23010,2023-02-01,"05,06,13,23,26","01,06",5,6,13,23,26,1,6,73,21,3,2,7,5,1,1,2,2,1,0,2
23011,2023-02-04,"02,07,08,17,25","01,03",2,7,8,17,25,1,3,59,23,3,2,4,2,2,0,3,1,1,0,2
23012,2023-02-06,"07,16,17,18,28","02,03",7,16,17,18,28,2,3,86,21,2,3,5,1,1,1,1,3,1,0,2
23013,2023-02-08,"01,02,09,23,25","02,06",1,2,9,23,25,2,6,60,24,4,1,8,4,0,2,3,1,1,0,2
23014,2023-02-11,"03,08,18,22,24","01,09",3,8,18,22,24,1,9,75,21,1,4,10,8,2,0,2,3,0,1,1
23015,2023-02-13,"08,16,24,25,34","08,12",8,16,24,25,34,8,12,107,26,1,4,20,4,0,2,1,2,2,2,0
23016,2023-02-15,"02,04,12,31,32","07,11",2,4,12,31,32,7,11,81,30,1,4,18,4,2,0,3,0,2,2,0
23017,2023-02-18,"02,05,09,22,27","10,11",2,5,9,22,27,10,11,65,25,3,2,21,1,1,1,3,1,1,2,0
23018,2023-02-20,"04,08,17,26,30","03,11",4,8,17,26,30,3,11,85,26,1,4,14,8,2,0,2,1,2,1,1
23019,2023-02-22,"05,08,09,11,15","06,08",5,8,9,11,15,6,8,48,10,4,1,14,2,0,2,4,1,0,1,1
23020,2023-02-25,"05,06,23,25,28","06,09",5,6,23,25,28,6,9,87,23,3,2,15,3,1,1,2,1,2,1,1
23021,2023-02-27,"02,09,18,23,27","03,05",2,9,18,23,27,3,5,79,25,3,2,8,2,2,0,2,2,1,0,2
23022,2023-03-01,"07,11,15,26,28","08,10",7,11,15,26,28,8,10,87,21,3,2,18,2,0,2,2,1,2,2,0
23023,2023-03-04,"09,21,23,25,33","03,10",9,21,23,25,33,3,10,111,24,5,0,13,7,1,1,1,2,2,1,1
23024,2023-03-06,"11,15,24,27,30","01,10",11,15,24,27,30,1,10,107,19,3,2,11,9,1,1,1,2,2,1,1
23025,2023-03-08,"03,09,27,30,31","11,12",3,9,27,30,31,11,12,100,28,4,1,23,1,1,1,2,0,3,2,0
23026,2023-03-11,"02,13,24,27,30","01,06",2,13,24,27,30,1,6,96,28,2,3,7,5,1,1,1,2,2,0,2
23027,2023-03-13,"09,10,12,15,23","03,06",9,10,12,15,23,3,6,69,14,3,2,9,3,1,1,3,2,0,0,2
23028,2023-03-15,"01,03,29,30,34","04,12",1,3,29,30,34,4,12,97,33,3,2,16,8,0,2,2,0,3,1,1
23029,2023-03-18,"07,25,27,34,35","09,11",7,25,27,34,35,9,11,128,28,4,1,20,2,2,0,1,0,4,2,0
23030,2023-03-20,"06,11,12,20,35","05,12",6,11,12,20,35,5,12,84,29,2,3,17,7,1,1,3,1,1,1,1
23031,2023-03-22,"05,07,08,16,25","03,11",5,7,8,16,25,3,11,61,20,3,2,14,8,2,0,3,1,1,1,1
23032,2023-03-25,"05,06,18,28,30","02,07",5,6,18,28,30,2,7,87,25,1,4,9,5,1,1,2,1,2,1,1
23033,2023-03-27,"04,06,10,11,25","07,09",4,6,10,11,25,7,9,56,21,2,3,16,2,2,0,4,0,1,2,0
23034,2023-03-29,"07,09,10,15,24","04,12",7,9,10,15,24,4,12,65,17,3,2,16,8,0,2,3,2,0,1,1
23035,2023-04-01,"07,14,23,25,29","02,11",7,14,23,25,29,2,11,98,22,4,1,13,9,1,1,1,2,2,1,1
23036,2023-04-03,"01,13,22,26,31","02,10",1,13,22,26,31,2,10,93,30,3,2,12,8,0,2,1,2,2,1,1
23037,2023-04-05,"06,08,16,20,24","07,08",6,8,16,20,24,7,8,74,18,0,5,15,1,1,1,2,3,0,2,0
23038,2023-04-08,"04,10,18,27,32","10,12",4,10,18,27,32,10,12,91,28,1,4,22,2,0,2,2,1,2,2,0
23039,2023-04-10,"02,24,26,30,34","06,07",2,24,26,30,34,6,7,116,32,0,5,13,1,1,1,1,1,3,1,1
23040,2023-04-12,"04,05,18,22,30","05,12",4,5,18,22,30,5,12,79,26,1,4,17,7,1,1,2,2,1,1,1
23041,2023-04-15,"05,08,13,26,35","05,09",5,8,13,26,35,5,9,87,30,3,2,14,4,2,0,2,1,2,1,1
23042,2023-04-17,"02,16,21,23,27","01,08",2,16,21,23,27,1,8,89,25,3,2,9,7,1,1,1,3,1,1,1
23043,2023-04-19,"02,04,17,20,27","01,08",2,4,17,20,27,1,8,70,25,2,3,9,7,1,1,2,2,1,1,1
23044,2023-04-22,"02,06,07,08,15","07,10",2,6,7,8,15,7,10,38,13,2,3,17,3,1,1,4,1,0,2,0
23045,2023-04-24,"07,10,13,28,31","04,05",7,10,13,28,31,4,5,89,24,3,2,9,1,1,1,2,1,2,0,2
23046,2023-04-26,"13,21,25,28,32","02,10",13,21,25,28,32,2,10,119,19,3,2,12,8,0,2,0,2,3,1,1
23047,2023-04-29,"10,12,13,24,25","11,12",10,12,13,24,25,11,12,84,15,2,3,23,1,1,1,2,2,1,2,0
23048,2023-05-01,"07,13,16,25,32","09,11",7,13,16,25,32,9,11,93,25,3,2,20,2,2,0,1,2,2,2,0
23049,2023-05-03,"03,17,22,26,28","07,12",3,17,22,26,28,7,12,96,25,2,3,19,5,1,1,1,2,2,2,0
23050,2023-05-06,"08,09,14,25,29","04,06",8,9,14,25,29,4,6,85,21,3,2,10,2,0,2,2,1,2,0,2
23051,2023-05-08,"03,11,19,29,33","03,12",3,11,19,29,33,3,12,95,30,5,0,15,9,1,1,2,1,2,1,1
23052,2023-05-10,"02,08,11,30,33","05,08",2,8,11,30,33,5,8,84,31,2,3,13,3,1,1,3,0,2,1,1
23053,2023-05-13,"01,03,11,14,20","02,11",1,3,11,14,20,2,11,49,19,3,2,13,9,1,1,3,2,0,1,1
23054,2023-05-15,"19,25,30,31,34","07,09",19,25,30,31,34,7,9,139,15,3,2,16,2,2,0,0,1,4,2,0
23055,2023-05-17,"06,08,12,13,15","01,06",6,8,12,13,15,1,6,54,9,2,3,7,5,1,1,3,2,0,0,2
23056,2023-05-20,"13,22,24,33,34","01,02",13,22,24,33,34,1,2,126,21,2,3,3,1,1,1,0,3,2,0,2
23057,2023-05-22,"01,05,06,19,24","05,11",1,5,6,19,24,5,11,55,23,3,2,16,6,2,0,3,2,0,1,1
23058,2023-05-24,"19,22,29,32,35","05,08",19,22,29,32,35,5,8,137,16,3,2,13,3,1,1,0,2,3,1,1
23059,2023-05-27,"09,13,23,25,28","04,07",9,13,23,25,28,4,7,98,19,4,1,11,3,1,1,1,2,2,1,1
23060,2023-05-29,"02,07,19,24,30","09,12",2,7,19,24,30,9,12,82,28,2,3,21,3,1,1,2,2,1,2,0
23061,2023-05-31,"07,11,21,30,32","05,07",7,11,21,30,32,5,7,101,25,3,2,12,2,2,0,2,1,2,1,1
23062,2023-06-03,"06,08,22,24,30","01,08",6,8,22,24,30,1,8,90,24,0,5,9,7,1,1,2,2,1,1,1
23063,2023-06-05,"04,18,29,31,34","06,09",4,18,29,31,34,6,9,116,30,2,3,15,3,1,1,1,1,3,1,1
23064,2023-06-07,"02,06,09,31,32","03,07",2,6,9,31,32,3,7,80,30,2,3,10,4,2,0,3,0,2,1,1
23065,2023-06-10,"08,14,16,21,25","03,12",8,14,16,21,25,3,12,84,17,2,3,15,9,1,1,1,3,1,1,1
23066,2023-06-12,"06,11,13,30,32","01,03",6,11,13,30,32,1,3,92,26,2,3,4,2,2,0,2,1,2,0,2
23067,2023-06-14,"02,28,30,33,35","02,10",2,28,30,33,35,2,10,128,33,2,3,12,8,0,2,1,0,4,1,1
23068,2023-06-17,"21,22,24,27,31","07,08",21,22,24,27,31,7,8,125,10,3,2,15,1,1,1,0,3,2,2,0
23069,2023-06-19,"08,20,21,25,32","05,07",8,20,21,25,32,5,7,106,24,2,3,12,2,2,0,1,2,2,1,1
23070,2023-06-21,"10,26,29,32,33","03,11",10,26,29,32,33,3,11,130,23,2,3,14,8,2,0,1,0,4,1,1
23071,2023-06-24,"02,11,12,32,34","10,12",2,11,12,32,34,10,12,91,32,1,4,22,2,0,2,3,0,2,2,0
23072,2023-06-26,"05,06,09,11,14","02,04",5,6,9,11,14,2,4,45,9,3,2,6,2,0,2,4,1,0,0,2
23073,2023-06-28,"15,25,28,30,35","08,10",15,25,28,30,35,8,10,133,20,3,2,18,2,0,2,0,1,4,2,0
23074,2023-07-01,"03,13,22,29,34","02,09",3,13,22,29,34,2,9,101,31,3,2,11,7,1,1,1,2,2,1,1
23075,2023-07-03,"07,17,20,23,32","05,11",7,17,20,23,32,5,11,99,25,3,2,16,6,2,0,1,3,1,1,1
23076,2023-07-05,"08,09,11,26,34","02,07",8,9,11,26,34,2,7,88,26,2,3,9,5,1,1,3,0,2,1,1
23077,2023-07-08,"05,16,18,26,35","03,06",5,16,18,26,35,3,6,100,30,2,3,9,3,1,1,1,2,2,0,2
23078,2023-07-10,"02,03,06,26,27","07,08",2,3,6,26,27,7,8,64,25,2,3,15,1,1,1,3,0,2,2,0
23079,2023-07-12,"06,08,26,29,34","05,08",6,8,26,29,34,5,8,103,28,1,4,13,3,1,1,2,0,3,1,1
23080,2023-07-15,"01,02,09,16,30","01,11",1,2,9,16,30,1,11,58,29,2,3,12,10,2,0,3,1,1,1,1
23081,2023-07-17,"05,06,23,28,35","07,10",5,6,23,28,35,7,10,97,30,3,2,17,3,1,1,2,1,2,2,0
23082,2023-07-19,"02,08,09,15,20","03,09",2,8,9,15,20,3,9,54,18,2,3,12,6,2,0,3,2,0,1,1
23083,2023-07-22,"13,15,21,25,32","09,10",13,15,21,25,32,9,10,106,19,4,1,19,1,1,1,0,3,2,2,0
23084,2023-07-24,"03,05,08,24,32","07,08",3,5,8,24,32,7,8,72,29,2,3,15,1,1,1,3,1,1,2,0
23085,2023-07-26,"11,12,26,31,35","05,07",11,12,26,31,35,5,7,115,24,3,2,12,2,2,0,2,0,3,1,1
23086,2023-07-29,"03,11,15,20,35","07,11",3,11,15,20,35,7,11,84,32,4,1,18,4,2,0,2,2,1,2,0
23087,2023-07-31,"03,04,16,19,24","04,05",3,4,16,19,24,4,5,66,21,2,3,9,1,1,1,2,3,0,0,2
23088,2023-08-02,"08,14,16,22,24","09,12",8,14,16,22,24,9,12,84,16,0,5,21,3,1,1,1,4,0,2,0
23089,2023-08-05,"03,12,20,26,35","02,12",3,12,20,26,35,2,12,96,32,2,3,14,10,0,2,2,1,2,1,1
23090,2023-08-07,"08,11,12,19,35","11,12",8,11,12,19,35,11,12,85,27,3,2,23,1,1,1,3,1,1,2,0
23091,2023-08-09,"06,16,18,28,29","07,11",6,16,18,28,29,7,11,97,23,1,4,18,4,2,0,1,2,2,2,0
23092,2023-08-12,"03,16,21,26,32","03,12",3,16,21,26,32,3,12,98,29,2,3,15,9,1,1,1,2,2,1,1
23093,2023-08-14,"11,14,17,19,21","01,05",11,14,17,19,21,1,5,82,10,4,1,6,4,2,0,1,4,0,0,2
23094,2023-08-16,"12,19,22,28,32","08,12",12,19,22,28,32,8,12,113,20,1,4,20,4,0,2,1,2,2,2,0
23095,2023-08-19,"08,19,28,32,34","03,07",8,19,28,32,34,3,7,121,26,1,4,10,4,2,0,1,1,3,1,1
23096,2023-08-21,"06,07,14,21,31","03,10",6,7,14,21,31,3,10,79,25,3,2,13,7,1,1,2,2,1,1,1
23097,2023-08-23,"06,07,18,20,22","03,09",6,7,18,20,22,3,9,73,16,1,4,12,6,2,0,2,3,0,1,1
23098,2023-08-26,"02,07,15,30,34","05,09",2,7,15,30,34,5,9,88,32,2,3,14,4,2,0,2,1,2,1,1
23099,2023-08-28,"09,11,13,22,23","06,07",9,11,13,22,23,6,7,78,14,4,1,13,1,1,1,2,3,0,1,1
23100,2023-08-30,"04,06,13,19,35","09,11",4,6,13,19,35,9,11,77,31,3,2,20,2,2,0,2,2,1,2,0
23101,2023-09-02,"06,14,16,17,28","07,10",6,14,16,17,28,7,10,81,22,1,4,17,3,1,1,1,3,1,2,0
23102,2023-09-04,"02,04,07,16,33","07,11",2,4,7,16,33,7,11,62,31,2,3,18,4,2,0,3,1,1,2,0
23103,2023-09-06,"08,11,19,31,32","08,11",8,11,19,31,32,8,11,101,24,3,2,19,3,1,1,2,1,2,2,0
23104,2023-09-09,"06,15,16,32,33","08,10",6,15,16,32,33,8,10,102,27,2,3,18,2,0,2,1,2,2,2,0
23105,2023-09-11,"07,08,19,20,25","02,11",7,8,19,20,25,2,11,79,18,3,2,13,9,1,1,2,2,1,1,1
23106,2023-09-13,"16,24,26,28,31","01,06",16,24,26,28,31,1,6,125,15,1,4,7,5,1,1,0,2,3,0,2
23107,2023-09-16,"01,12,15,16,18","03,10",1,12,15,16,18,3,10,62,17,2,3,13,7,1,1,2,3,0,1,1
23108,2023-09-18,"05,06,17,30,32","02,08",5,6,17,30,32,2,8,90,27,2,3,10,6,0,2,2,1,2,1,1
23109,2023-09-20,"01,12,21,22,31","02,09",1,12,21,22,31,2,9,87,30,3,2,11,7,1,1,2,2,1,1,1
23110,2023-09-23,"04,09,11,13,17","07,08",4,9,11,13,17,7,8,54,13,4,1,15,1,1,1,3,2,0,2,0
23111,2023-09-25,"03,12,15,28,35","02,12",3,12,15,28,35,2,12,93,32,3,2,14,10,0,2,2,1,2,1,1
23112,2023-09-27,"01,11,17,22,27","02,09",1,11,17,22,27,2,9,78,26,4,1,11,7,1,1,2,2,1,1,1
23113,2023-09-30,"06,08,30,32,33","03,10",6,8,30,32,33,3,10,109,27,1,4,13,7,1,1,2,0,3,1,1
23114,2023-10-07,"02,25,27,30,35","01,10",2,25,27,30,35,1,10,119,33,3,2,11,9,1,1,1,0,4,1,1
23115,2023-10-09,"07,10,23,31,34","02,10",7,10,23,31,34,2,10,105,27,3,2,12,8,0,2,2,1,2,1,1
23116,2023-10-11,"01,03,09,18,29","04,09",1,3,9,18,29,4,9,60,28,4,1,13,5,1,1,3,1,1,1,1
23117,2023-10-14,"05,07,15,18,20","03,04",5,7,15,18,20,3,4,65,15,3,2,7,1,1,1,2,3,0,0,2
23118,2023-10-16,"06,07,13,25,33","05,08",6,7,13,25,33,5,8,84,27,4,1,13,3,1,1,2,1,2,1,1
23119,2023-10-18,"04,08,10,14,21","04,10",4,8,10,14,21,4,10,57,17,1,4,14,6,0,2,3,2,0,1,1
23120,2023-10-21,"02,08,16,31,34","01,10",2,8,16,31,34,1,10,91,32,1,4,11,9,1,1,2,1,2,1,1
23121,2023-10-23,"05,11,15,23,33","01,09",5,11,15,23,33,1,9,87,28,5,0,10,8,2,0,2,2,1,1,1
23122,2023-10-25,"01,07,09,25,29","10,12",1,7,9,25,29,10,12,71,28,5,0,22,2,0,2,3,0,2,2,0
23123,2023-10-28,"02,14,16,28,30","02,07",2,14,16,28,30,2,7,90,28,0,5,9,5,1,1,1,2,2,1,1
23124,2023-10-30,"06,18,23,27,32","06,10",6,18,23,27,32,6,10,106,26,2,3,16,4,0,2,1,2,2,1,1
23125,2023-11-01,"07,25,26,29,32","02,08",7,25,26,29,32,2,8,119,25,3,2,10,6,0,2,1,0,4,1,1
23126,2023-11-04,"07,12,17,26,34","02,06",7,12,17,26,34,2,6,96,27,2,3,8,4,0,2,2,1,2,0,2
23127,2023-11-06,"04,07,08,18,19","02,06",4,7,8,18,19,2,6,56,15,2,3,8,4,0,2,3,2,0,0,2
23128,2023-11-08,"01,05,07,12,13","02,06",1,5,7,12,13,2,6,38,12,4,1,8,4,0,2,4,1,0,0,2
23129,2023-11-11,"09,23,25,27,33","06,12",9,23,25,27,33,6,12,117,24,5,0,18,6,0,2,1,1,3,1,1
23130,2023-11-13,"13,20,27,29,30","01,07",13,20,27,29,30,1,7,119,17,3,2,8,6,2,0,0,2,3,1,1
23131,2023-11-15,"03,07,21,22,24","06,07",3,7,21,22,24,6,7,77,21,3,2,13,1,1,1,2,3,0,1,1
23132,2023-11-18,"03,04,12,15,23","02,06",3,4,12,15,23,2,6,57,20,3,2,8,4,0,2,3,2,0,0,2
23133,2023-11-20,"10,18,25,28,33","05,11",10,18,25,28,33,5,11,114,23,2,3,16,6,2,0,1,1,3,1,1
23134,2023-11-22,"10,15,22,27,33","01,12",10,15,22,27,33,1,12,107,23,3,2,13,11,1,1,1,2,2,1,1
23135,2023-11-25,"05,18,22,28,29","09,12",5,18,22,28,29,9,12,102,24,2,3,21,3,1,1,1,2,2,2,0
23136,2023-11-27,"13,23,27,30,34","06,09",13,23,27,30,34,6,9,127,21,3,2,15,3,1,1,0,2,3,1,1
23137,2023-11-29,"04,19,21,30,31","06,12",4,19,21,30,31,6,12,105,27,3,2,18,6,0,2,1,2,2,1,1
23138,2023-12-02,"07,12,20,28,31","09,10",7,12,20,28,31,9,10,98,24,2,3,19,1,1,1,2,1,2,2,0
23139,2023-12-04,"15,16,25,31,34","05,09",15,16,25,31,34,5,9,121,19,3,2,14,4,2,0,0,2,3,1,1
23140,2023-12-06,"01,02,09,19,30","01,02",1,2,9,19,30,1,2,61,29,3,2,3,1,1,1,3,1,1,0,2
23141,2023-12-09,"04,22,25,30,31","04,05",4,22,25,30,31,4,5,112,27,2,3,9,1,1,1,1,1,3,0,2
23142,2023-12-11,"04,13,15,17,32","10,12",4,13,15,17,32,10,12,81,28,3,2,22,2,0,2,1,3,1,2,0
23143,2023-12-13,"09,20,23,29,33","02,10",9,20,23,29,33,2,10,114,24,4,1,12,8,0,2,1,2,2,1,1
23144,2023-12-16,"05,14,18,25,35","01,10",5,14,18,25,35,1,10,97,30,3,2,11,9,1,1,1,2,2,1,1
23145,2023-12-18,"06,10,12,32,33","06,07",6,10,12,32,33,6,7,93,27,1,4,13,1,1,1,3,0,2,1,1
23146,2023-12-20,"14,18,19,26,31","02,07",14,18,19,26,31,2,7,108,17,2,3,9,5,1,1,0,3,2,1,1
23147,2023-12-23,"06,07,19,33,34","03,08",6,7,19,33,34,3,8,99,28,3,2,11,5,1,1,2,1,2,1,1
23148,2023-12-25,"11,12,20,21,27","02,12",11,12,20,21,27,2,12,91,16,3,2,14,10,0,2,2,2,1,1,1
23149,2023-12-27,"01,16,17,21,29","01,06",1,16,17,21,29,1,6,84,28,4,1,7,5,1,1,1,3,1,0,2
23150,2023-12-30,"05,06,17,18,33","11,12",5,6,17,18,33,11,12,79,28,3,2,23,1,1,1,2,2,1,2,0
24001,2024-01-01,"03,09,17,26,35","02,07",3,9,17,26,35,2,7,90,32,4,1,9,5,1,1,2,1,2,1,1
24002,2024-01-03,"01,06,08,27,32","03,04",1,6,8,27,32,3,4,74,31,2,3,7,1,1,1,3,0,2,0,2
24003,2024-01-06,"07,09,12,23,29","01,02",7,9,12,23,29,1,2,80,22,4,1,3,1,1,1,3,1,1,0,2
24004,2024-01-08,"02,06,18,19,27","08,09",2,6,18,19,27,8,9,72,25,2,3,17,1,1,1,2,2,1,2,0
24005,2024-01-10,"03,05,07,09,12","05,08",3,5,7,9,12,5,8,36,9,4,1,13,3,1,1,5,0,0,1,1
24006,2024-01-13,"08,13,16,17,33","02,10",8,13,16,17,33,2,10,87,25,3,2,12,8,0,2,1,3,1,1,1
24007,2024-01-15,"04,05,28,34,35","04,11",4,5,28,34,35,4,11,106,31,2,3,15,7,1,1,2,0,3,1,1
24008,2024-01-17,"04,06,11,20,30","03,05",4,6,11,20,30,3,5,71,26,1,4,8,2,2,0,3,1,1,0,2
24009,2024-01-20,"15,18,19,24,26","05,09",15,18,19,24,26,5,9,102,11,2,3,14,4,2,0,0,4,1,1,1
24010,2024-01-22,"02,08,10,15,27","02,08",2,8,10,15,27,2,8,62,25,2,3,10,6,0,2,3,1,1,1,1
24011,2024-01-24,"01,03,27,32,34","01,07",1,3,27,32,34,1,7,97,33,3,2,8,6,2,0,2,0,3,1,1
24012,2024-01-27,"21,22,25,26,34","01,09",21,22,25,26,34,1,9,128,13,2,3,10,8,2,0,0,2,3,1,1
24013,2024-01-29,"05,22,25,28,30","03,12",5,22,25,28,30,3,12,110,25,2,3,15,9,1,1,1,1,3,1,1
24014,2024-01-31,"04,05,16,21,31","09,11",4,5,16,21,31,9,11,77,27,3,2,20,2,2,0,2,2,1,2,0
24015,2024-02-03,"08,11,14,24,31","05,06",8,11,14,24,31,5,6,88,23,2,3,11,1,1,1,2,2,1,0,2
24016,2024-02-05,"15,18,25,27,29","06,11",15,18,25,27,29,6,11,114,14,4,1,17,5,1,1,0,2,3,1,1
24017,2024-02-07,"03,07,25,27,35","01,04",3,7,25,27,35,1,4,97,32,5,0,5,3,1,1,2,0,3,0,2
24018,2024-02-19,"04,12,19,25,27","01,09",4,12,19,25,27,1,9,87,23,3,2,10,8,2,0,2,1,2,1,1
24019,2024-02-21,"19,20,26,29,30","03,04",19,20,26,29,30,3,4,124,11,2,3,7,1,1,1,0,2,3,0,2
24020,2024-02-24,"02,04,08,19,26","02,06",2,4,8,19,26,2,6,59,24,1,4,8,4,0,2,3,1,1,0,2
24021,2024-02-26,"01,12,16,20,28","07,09",1,12,16,20,28,7,9,77,27,1,4,16,2,2,0,2,2,1,2,0
24022,2024-02-28,"07,09,11,31,32","04,08",7,9,11,31,32,4,8,90,25,4,1,12,4,0,2,3,0,2,1,1
24023,2024-03-02,"08,10,12,14,22","05,09",8,10,12,14,22,5,9,66,14,0,5,14,4,2,0,3,2,0,1,1
24024,2024-03-04,"03,05,12,17,26","01,12",3,5,12,17,26,1,12,63,23,3,2,13,11,1,1,3,1,1,1,1
24025,2024-03-06,"01,02,08,18,27","04,08",1,2,8,18,27,4,8,56,26,2,3,12,4,0,2,3,1,1,1,1
24026,2024-03-09,"01,18,21,26,33","02,12",1,18,21,26,33,2,12,99,32,3,2,14,10,0,2,1,2,2,1,1
24027,2024-03-11,"08,09,16,22,23","07,09",8,9,16,22,23,7,9,78,15,2,3,16,2,2,0,2,3,0,2,0
24028,2024-03-13,"13,18,20,26,28","04,08",13,18,20,26,28,4,8,105,15,1,4,12,4,0,2,0,3,2,1,1
24029,2024-03-16,"04,19,24,28,34","04,05",4,19,24,28,34,4,5,109,30,1,4,9,1,1,1,1,2,2,0,2
24030,2024-03-18,"08,09,11,19,30","06,12",8,9,11,19,30,6,12,77,22,3,2,18,6,0,2,3,1,1,1,1
24031,2024-03-20,"09,12,15,30,34","05,06",9,12,15,30,34,5,6,100,25,2,3,11,1,1,1,2,1,2,0,2
24032,2024-03-23,"05,15,26,33,35","01,09",5,15,26,33,35,1,9,114,30,4,1,10,8,2,0,1,1,3,1,1
24033,2024-03-25,"04,08,10,11,15","07,09",4,8,10,11,15,7,9,48,11,2,3,16,2,2,0,4,1,0,2,0
24034,2024-03-27,"23,26,27,29,33","05,08",23,26,27,29,33,5,8,138,10,4,1,13,3,1,1,0,1,4,1,1
24035,2024-03-30,"05,13,17,29,33","05,12",5,13,17,29,33,5,12,97,28,5,0,17,7,1,1,1,2,2,1,1
24036,2024-04-01,"02,05,11,32,34","06,10",2,5,11,32,34,6,10,84,32,2,3,16,4,0,2,3,0,2,1,1
24037,2024-04-03,"17,19,20,29,35","07,11",17,19,20,29,35,7,11,120,18,4,1,18,4,2,0,0,3,2,2,0
24038,2024-04-06,"15,22,24,25,29","01,05",15,22,24,25,29,1,5,115,14,3,2,6,4,2,0,0,3,2,0,2
24039,2024-04-08,"03,10,11,20,22","06,10",3,10,11,20,22,6,10,66,19,2,3,16,4,0,2,3,2,0,1,1
24040,2024-04-10,"05,12,16,29,30","03,06",5,12,16,29,30,3,6,92,25,2,3,9,3,1,1,2,1,2,0,2
24041,2024-04-13,"06,08,14,16,28","03,05",6,8,14,16,28,3,5,72,22,0,5,8,2,2,0,2,2,1,0,2
24042,2024-04-15,"01,08,15,23,35","05,12",1,8,15,23,35,5,12,82,34,4,1,17,7,1,1,2,2,1,1,1
24043,2024-04-17,"03,04,08,14,27","05,07",3,4,8,14,27,5,7,56,24,2,3,12,2,2,0,3,1,1,1,1
24044,2024-04-20,"03,13,15,17,22","06,10",3,13,15,17,22,6,10,70,19,4,1,16,4,0,2,1,4,0,1,1
24045,2024-04-22,"09,10,14,31,32","03,08",9,10,14,31,32,3,8,96,23,2,3,11,5,1,1,2,1,2,1,1
24046,2024-04-24,"06,12,17,29,30","07,11",6,12,17,29,30,7,11,94,24,2,3,18,4,2,0,2,1,2,2,0
24047,2024-04-27,"11,19,21,26,35","10,11",11,19,21,26,35,10,11,112,24,4,1,21,1,1,1,1,2,2,2,0
24048,2024-04-29,"12,18,21,26,28","08,09",12,18,21,26,28,8,9,105,16,1,4,17,1,1,1,1,2,2,2,0
24049,2024-05-01,"04,06,09,10,22","01,08",4,6,9,10,22,1,8,51,18,1,4,9,7,1,1,4,1,0,1,1
24050,2024-05-04,"03,04,14,18,26","07,09",3,4,14,18,26,7,9,65,23,1,4,16,2,2,0,2,2,1,2,0
24051,2024-05-06,"05,21,22,23,29","01,02",5,21,22,23,29,1,2,100,24,4,1,3,1,1,1,1,3,1,0,2
24052,2024-05-08,"02,03,13,22,34","04,08",2,3,13,22,34,4,8,74,32,2,3,12,4,0,2,2,2,1,1,1
24053,2024-05-11,"01,07,19,20,35","03,09",1,7,19,20,35,3,9,82,34,4,1,12,6,2,0,2,2,1,1,1
24054,2024-05-13,"05,06,09,11,22","01,03",5,6,9,11,22,1,3,53,17,3,2,4,2,2,0,4,1,0,0,2
24055,2024-05-15,"07,17,22,30,34","05,07",7,17,22,30,34,5,7,110,27,2,3,12,2,2,0,1,2,2,1,1
24056,2024-05-18,"16,17,18,27,35","06,12",16,17,18,27,35,6,12,113,19,3,2,18,6,0,2,0,3,2,1,1
24057,2024-05-20,"09,25,30,33,34","03,09",9,25,30,33,34,3,9,131,25,3,2,12,6,2,0,1,0,4,1,1
24058,2024-05-22,"06,10,13,20,32","01,02",6,10,13,20,32,1,2,81,26,1,4,3,1,1,1,2,2,1,0,2
24059,2024-05-25,"17,18,20,25,31","03,12",17,18,20,25,31,3,12,111,14,3,2,15,9,1,1,0,3,2,1,1
24060,2024-05-27,"03,21,25,28,30","01,12",3,21,25,28,30,1,12,107,27,3,2,13,11,1,1,1,1,3,1,1
24061,2024-05-29,"01,12,19,31,33","05,08",1,12,19,31,33,5,8,96,32,4,1,13,3,1,1,2,1,2,1,1
24062,2024-06-01,"05,14,15,16,33","03,05",5,14,15,16,33,3,5,83,28,3,2,8,2,2,0,1,3,1,0,2
24063,2024-06-03,"07,12,16,33,34","01,03",7,12,16,33,34,1,3,102,27,2,3,4,2,2,0,2,1,2,0,2
24064,2024-06-05,"05,12,21,32,33","08,09",5,12,21,32,33,8,9,103,28,3,2,17,1,1,1,2,1,2,2,0
24065,2024-06-08,"05,10,18,26,27","03,06",5,10,18,26,27,3,6,86,22,2,3,9,3,1,1,2,1,2,0,2
24066,2024-06-10,"13,19,20,24,25","06,07",13,19,20,24,25,6,7,101,12,3,2,13,1,1,1,0,4,1,1,1
24067,2024-06-12,"03,11,14,20,22","06,09",3,11,14,20,22,6,9,70,19,2,3,15,3,1,1,2,3,0,1,1
24068,2024-06-15,"15,20,31,32,33","05,10",15,20,31,32,33,5,10,131,18,3,2,15,5,1,1,0,2,3,1,1
24069,2024-06-17,"07,09,16,20,24","03,07",7,9,16,20,24,3,7,76,17,2,3,10,4,2,0,2,3,0,1,1
24070,2024-06-19,"04,20,21,32,34","02,09",4,20,21,32,34,2,9,111,30,1,4,11,7,1,1,1,2,2,1,1
24071,2024-06-22,"06,10,15,34,35","02,10",6,10,15,34,35,2,10,100,29,2,3,12,8,0,2,2,1,2,1,1
24072,2024-06-24,"04,17,21,23,32","01,06",4,17,21,23,32,1,6,97,28,3,2,7,5,1,1,1,3,1,0,2
24073,2024-06-26,"07,09,12,21,23","05,09",7,9,12,21,23,5,9,72,16,4,1,14,4,2,0,3,2,0,1,1
24074,2024-06-29,"02,10,11,21,27","09,11",2,10,11,21,27,9,11,71,25,3,2,20,2,2,0,3,1,1,2,0
24075,2024-07-01,"08,17,26,28,32","01,10",8,17,26,28,32,1,10,111,24,1,4,11,9,1,1,1,1,3,1,1
24076,2024-07-03,"01,06,22,27,35","07,12",1,6,22,27,35,7,12,91,34,3,2,19,5,1,1,2,1,2,2,0
24077,2024-07-06,"01,03,25,26,29","06,12",1,3,25,26,29,6,12,84,28,4,1,18,6,0,2,2,0,3,1,1
24078,2024-07-08,"05,07,10,14,15","04,07",5,7,10,14,15,4,7,51,10,3,2,11,3,1,1,3,2,0,1,1
24079,2024-07-10,"03,08,17,18,23","06,11",3,8,17,18,23,6,11,69,20,3,2,17,5,1,1,2,3,0,1,1
24080,2024-07-13,"03,05,24,27,28","09,11",3,5,24,27,28,9,11,87,25,3,2,20,2,2,0,2,1,2,2,0
24081,2024-07-15,"14,15,25,27,34","01,10",14,15,25,27,34,1,10,115,20,3,2,11,9,1,1,0,2,3,1,1
24082,2024-07-17,"08,21,23,24,26","04,05",8,21,23,24,26,4,5,102,18,2,3,9,1,1,1,1,3,1,0,2
24083,2024-07-20,"09,11,12,13,30","07,09",9,11,12,13,30,7,9,75,21,3,2,16,2,2,0,3,1,1,2,0
24084,2024-07-22,"04,11,16,17,23","05,10",4,11,16,17,23,5,10,71,19,3,2,15,5,1,1,2,3,0,1,1
24085,2024-07-24,"02,09,16,29,35","01,06",2,9,16,29,35,1,6,91,33,3,2,7,5,1,1,2,1,2,0,2
24086,2024-07-27,"11,12,14,22,28","07,11",11,12,14,22,28,7,11,87,17,1,4,18,4,2,0,2,2,1,2,0
24087,2024-07-29,"07,10,20,28,34","05,10",7,10,20,28,34,5,10,99,27,1,4,15,5,1,1,2,1,2,1,1
24088,2024-07-31,"01,02,23,28,32","03,05",1,2,23,28,32,3,5,86,31,2,3,8,2,2,0,2,1,2,0,2
24089,2024-08-03,"05,06,29,30,34","07,08",5,6,29,30,34,7,8,104,29,2,3,15,1,1,1,2,0,3,2,0
24090,2024-08-05,"02,03,06,28,33","07,11",2,3,6,28,33,7,11,72,31,2,3,18,4,2,0,3,0,2,2,0
24091,2024-08-07,"01,08,11,17,21","01,02",1,8,11,17,21,1,2,58,20,4,1,3,1,1,1,3,2,0,0,2
24092,2024-08-10,"02,04,25,26,31","01,06",2,4,25,26,31,1,6,88,29,2,3,7,5,1,1,2,0,3,0,2
24093,2024-08-12,"16,24,26,28,29","08,12",16,24,26,28,29,8,12,123,13,1,4,20,4,0,2,0,2,3,2,0
24094,2024-08-14,"12,13,24,29,31","02,08",12,13,24,29,31,2,8,109,19,3,2,10,6,0,2,1,2,2,1,1
24095,2024-08-17,"01,07,19,26,27","03,05",1,7,19,26,27,3,5,80,26,4,1,8,2,2,0,2,1,2,0,2
24096,2024-08-19,"02,03,23,27,31","01,10",2,3,23,27,31,1,10,86,29,4,1,11,9,1,1,2,1,2,1,1
24097,2024-08-21,"07,11,12,14,19","02,08",7,11,12,14,19,2,8,63,12,3,2,10,6,0,2,3,2,0,1,1
24098,2024-08-24,"03,10,15,19,29","09,10",3,10,15,19,29,9,10,76,26,4,1,19,1,1,1,2,2,1,2,0
24099,2024-08-26,"04,10,24,31,35","05,08",4,10,24,31,35,5,8,104,31,2,3,13,3,1,1,2,1,2,1,1
24100,2024-08-28,"02,12,19,22,32","05,11",2,12,19,22,32,5,11,87,30,1,4,16,6,2,0,2,2,1,1,1
24101,2024-08-31,"16,19,22,27,35","06,10",16,19,22,27,35,6,10,119,19,3,2,16,4,0,2,0,3,2,1,1
24102,2024-09-02,"01,05,09,14,20","05,11",1,5,9,14,20,5,11,49,19,3,2,16,6,2,0,3,2,0,1,1
24103,2024-09-04,"19,21,29,32,33","06,08",19,21,29,32,33,6,8,134,14,4,1,14,2,0,2,0,2,3,1,1
24104,2024-09-07,"01,04,09,13,17","06,09",1,4,9,13,17,6,9,44,16,4,1,15,3,1,1,3,2,0,1,1
24105,2024-09-09,"14,20,21,28,32","09,11",14,20,21,28,32,9,11,115,18,1,4,20,2,2,0,0,3,2,2,0
24106,2024-09-11,"05,11,19,22,29","02,12",5,11,19,22,29,2,12,86,24,4,1,14,10,0,2,2,2,1,1,1
24107,2024-09-14,"06,14,16,18,34","03,10",6,14,16,18,34,3,10,88,28,0,5,13,7,1,1,1,3,1,1,1
24108,2024-09-16,"16,17,21,31,34","03,08",16,17,21,31,34,3,8,119,18,3,2,11,5,1,1,0,3,2,1,1
24109,2024-09-18,"12,23,26,27,28","03,11",12,23,26,27,28,3,11,116,16,2,3,14,8,2,0,1,1,3,1,1
24110,2024-09-21,"01,07,08,18,28","04,12",1,7,8,18,28,4,12,62,27,2,3,16,8,0,2,3,1,1,1,1
24111,2024-09-23,"03,09,19,27,30","07,11",3,9,19,27,30,7,11,88,27,4,1,18,4,2,0,2,1,2,2,0
24112,2024-09-25,"05,15,24,31,34","03,10",5,15,24,31,34,3,10,109,29,3,2,13,7,1,1,1,2,2,1,1
24113,2024-09-28,"16,18,25,26,33","04,08",16,18,25,26,33,4,8,118,17,2,3,12,4,0,2,0,2,3,1,1
24114,2024-09-30,"12,27,30,34,35","05,11",12,27,30,34,35,5,11,138,23,2,3,16,6,2,0,1,0,4,1,1
24115,2024-10-05,"03,04,12,19,24","08,12",3,4,12,19,24,8,12,62,21,2,3,20,4,0,2,3,2,0,2,0
24116,2024-10-07,"01,03,06,16,25","01,11",1,3,6,16,25,1,11,51,24,3,2,12,10,2,0,3,1,1,1,1
24117,2024-10-09,"02,10,22,26,28","02,04",2,10,22,26,28,2,4,88,26,0,5,6,2,0,2,2,1,2,0,2
24118,2024-10-12,"01,03,09,16,19","05,11",1,3,9,16,19,5,11,48,18,4,1,16,6,2,0,3,2,0,1,1
24119,2024-10-14,"06,12,28,30,33","02,07",6,12,28,30,33,2,7,109,27,1,4,9,5,1,1,2,0,3,1,1
24120,2024-10-16,"04,12,17,23,27","02,08",4,12,17,23,27,2,8,83,23,3,2,10,6,0,2,2,2,1,1,1
24121,2024-10-19,"07,15,18,24,33","04,05",7,15,18,24,33,4,5,97,26,3,2,9,1,1,1,1,3,1,0,2
24122,2024-10-21,"05,06,09,15,17","03,10",5,6,9,15,17,3,10,52,12,4,1,13,7,1,1,3,2,0,1,1
24123,2024-10-23,"03,09,16,30,31","08,09",3,9,16,30,31,8,9,89,28,3,2,17,1,1,1,2,1,2,2,0
24124,2024-10-26,"02,03,07,10,25","01,11",2,3,7,10,25,1,11,47,23,3,2,12,10,2,0,4,0,1,1,1
24125,2024-10-28,"10,14,19,24,26","01,10",10,14,19,24,26,1,10,93,16,1,4,11,9,1,1,1,3,1,1,1
24126,2024-10-30,"02,10,17,28,34","07,08",2,10,17,28,34,7,8,91,32,1,4,15,1,1,1,2,1,2,2,0
24127,2024-11-02,"02,03,10,16,28","07,10",2,3,10,16,28,7,10,59,26,1,4,17,3,1,1,3,1,1,2,0
24128,2024-11-04,"03,07,10,29,31","01,03",3,7,10,29,31,1,3,80,28,4,1,4,2,2,0,3,0,2,0,2
24129,2024-11-06,"07,19,30,31,34","05,07",7,19,30,31,34,5,7,121,27,3,2,12,2,2,0,1,1,3,1,1
24130,2024-11-09,"11,21,25,31,32","04,10",11,21,25,31,32,4,10,120,21,4,1,14,6,0,2,1,1,3,1,1
24131,2024-11-11,"02,03,04,21,26","02,03",2,3,4,21,26,2,3,56,24,2,3,5,1,1,1,3,1,1,0,2
24132,2024-11-13,"05,06,10,16,31","06,09",5,6,10,16,31,6,9,68,26,2,3,15,3,1,1,3,1,1,1,1
24133,2024-11-16,"08,10,14,22,29","04,06",8,10,14,22,29,4,6,83,21,1,4,10,2,0,2,2,2,1,0,2
24134,2024-11-18,"01,04,07,13,33","05,06",1,4,7,13,33,5,6,58,32,4,1,11,1,1,1,3,1,1,0,2
24135,2024-11-20,"06,08,22,24,30","03,08",6,8,22,24,30,3,8,90,24,0,5,11,5,1,1,2,2,1,1,1
24136,2024-11-23,"01,17,20,29,34","07,08",1,17,20,29,34,7,8,101,33,3,2,15,1,1,1,1,2,2,2,0
24137,2024-11-25,"08,15,16,17,21","02,05",8,15,16,17,21,2,5,77,13,3,2,7,3,1,1,1,4,0,0,2
24138,2024-11-27,"05,17,20,28,34","04,09",5,17,20,28,34,4,9,104,29,2,3,13,5,1,1,1,2,2,1,1
24139,2024-11-30,"05,12,20,23,24","05,07",5,12,20,23,24,5,7,84,19,2,3,12,2,2,0,2,3,0,1,1
24140,2024-12-02,"03,06,15,23,31","01,12",3,6,15,23,31,1,12,78,28,4,1,13,11,1,1,2,2,1,1,1
24141,2024-12-04,"02,06,07,16,20","02,11",2,6,7,16,20,2,11,51,18,1,4,13,9,1,1,3,2,0,1,1
24142,2024-12-07,"08,21,24,33,34","03,10",8,21,24,33,34,3,10,120,26,2,3,13,7,1,1,1,2,2,1,1
24143,2024-12-09,"16,20,22,24,31","04,05",16,20,22,24,31,4,5,113,15,1,4,9,1,1,1,0,4,1,0,2
24144,2024-12-11,"06,07,08,21,30","01,05",6,7,8,21,30,1,5,72,24,2,3,6,4,2,0,3,1,1,0,2
24145,2024-12-14,"01,06,09,22,24","01,03",1,6,9,22,24,1,3,62,23,2,3,4,2,2,0,3,2,0,0,2
24146,2024-12-16,"05,20,21,22,32","03,04",5,20,21,22,32,3,4,100,27,2,3,7,1,1,1,1,3,1,0,2
24147,2024-12-18,"12,18,21,22,31","01,07",12,18,21,22,31,1,7,104,19,2,3,8,6,2,0,1,3,1,1,1
24148,2024-12-21,"06,09,20,32,35","08,11",6,9,20,32,35,8,11,102,29,2,3,19,3,1,1,2,1,2,2,0
24149,2024-12-23,"02,05,16,18,22","07,09",2,5,16,18,22,7,9,63,20,1,4,16,2,2,0,2,3,0,2,0
24150,2024-12-25,"04,11,23,25,34","05,07",4,11,23,25,34,5,7,97,30,3,2,12,2,2,0,2,1,2,1,1
24151,2024-12-28,"05,12,17,19,35","10,11",5,12,17,19,35,10,11,88,30,4,1,21,1,1,1,2,2,1,2,0
24152,2024-12-30,"01,02,07,08,31","02,10",1,2,7,8,31,2,10,49,30,3,2,12,8,0,2,4,0,1,1,1
25001,2025-01-01,"05,08,16,17,27","04,07",5,8,16,17,27,4,7,73,22,3,2,11,3,1,1,2,2,1,1,1
25002,2025-01-04,"19,21,22,28,32","06,09",19,21,22,28,32,6,9,122,13,2,3,15,3,1,1,0,3,2,1,1
25003,2025-01-06,"10,25,30,32,34","04,10",10,25,30,32,34,4,10,131,24,1,4,14,6,0,2,1,0,4,1,1
25004,2025-01-08,"02,05,09,13,33","01,07",2,5,9,13,33,1,7,62,31,4,1,8,6,2,0,3,1,1,1,1
25005,2025-01-11,"05,06,08,31,32","09,11",5,6,8,31,32,9,11,82,27,2,3,20,2,2,0,3,0,2,2,0
25006,2025-01-13,"03,04,13,19,35","03,10",3,4,13,19,35,3,10,74,32,4,1,13,7,1,1,2,2,1,1,1
25007,2025-01-15,"15,22,23,25,31","01,09",15,22,23,25,31,1,9,116,16,4,1,10,8,2,0,0,3,2,1,1
25008,2025-01-18,"01,05,07,13,35","05,12",1,5,7,13,35,5,12,61,34,5,0,17,7,1,1,3,1,1,1,1
25009,2025-01-20,"03,19,21,30,32","06,09",3,19,21,30,32,6,9,105,29,3,2,15,3,1,1,1,2,2,1,1
25010,2025-01-22,"05,21,28,30,32","07,12",5,21,28,30,32,7,12,116,27,2,3,19,5,1,1,1,1,3,2,0
25011,2025-01-25,"03,06,07,11,27","02,08",3,6,7,11,27,2,8,54,24,4,1,10,6,0,2,4,0,1,1,1
25012,2025-02-08,"02,18,19,21,25","02,11",2,18,19,21,25,2,11,85,23,3,2,13,9,1,1,1,3,1,1,1
25013,2025-02-10,"14,16,18,20,35","02,05",14,16,18,20,35,2,5,103,21,1,4,7,3,1,1,0,4,1,0,2
25014,2025-02-12,"05,19,22,29,35","02,10",5,19,22,29,35,2,10,110,30,4,1,12,8,0,2,1,2,2,1,1
25015,2025-02-15,"07,10,24,31,35","01,08",7,10,24,31,35,1,8,107,28,3,2,9,7,1,1,2,1,2,1,1
25016,2025-02-17,"05,07,12,20,29","08,12",5,7,12,20,29,8,12,73,24,3,2,20,4,0,2,3,1,1,2,0
25017,2025-02-19,"10,12,26,28,31","03,10",10,12,26,28,31,3,10,107,21,1,4,13,7,1,1,2,0,3,1,1
25018,2025-02-22,"01,07,09,20,28","01,04",1,7,9,20,28,1,4,65,27,3,2,5,3,1,1,3,1,1,0,2
25019,2025-02-24,"07,08,11,18,23","03,11",7,8,11,18,23,3,11,67,16,3,2,14,8,2,0,3,2,0,1,1
25020,2025-02-26,"01,09,12,22,29","05,09",1,9,12,22,29,5,9,73,28,3,2,14,4,2,0,3,1,1,1,1
25021,2025-03-01,"10,18,25,30,35","03,12",10,18,25,30,35,3,12,118,25,2,3,15,9,1,1,1,1,3,1,1
25022,2025-03-03,"01,11,13,27,29","04,10",1,11,13,27,29,4,10,81,28,5,0,14,6,0,2,2,1,2,1,1
25023,2025-03-05,"10,20,22,24,25","09,12",10,20,22,24,25,9,12,101,15,1,4,21,3,1,1,1,3,1,2,0
25024,2025-03-08,"06,12,13,16,23","05,08",6,12,13,16,23,5,8,70,17,2,3,13,3,1,1,2,3,0,1,1
25025,2025-03-10,"03,06,08,10,25","03,07",3,6,8,10,25,3,7,52,22,2,3,10,4,2,0,4,0,1,1,1
25026,2025-03-12,"02,03,07,17,30","01,09",2,3,7,17,30,1,9,59,28,3,2,10,8,2,0,3,1,1,1,1
25027,2025-03-15,"03,06,11,13,20","01,11",3,6,11,13,20,1,11,53,17,3,2,12,10,2,0,3,2,0,1,1
25028,2025-03-17,"06,08,20,25,29","03,07",6,8,20,25,29,3,7,88,23,2,3,10,4,2,0,2,1,2,1,1
25029,2025-03-19,"05,09,26,31,33","03,10",5,9,26,31,33,3,10,104,28,4,1,13,7,1,1,2,0,3,1,1
25030,2025-03-22,"03,09,14,24,28","06,07",3,9,14,24,28,6,7,78,25,2,3,13,1,1,1,2,2,1,1,1
25031,2025-03-24,"14,18,20,25,35","01,07",14,18,20,25,35,1,7,112,21,2,3,8,6,2,0,0,3,2,1,1
25032,2025-03-26,"12,22,25,27,28","01,02",12,22,25,27,28,1,2,114,16,2,3,3,1,1,1,1,1,3,0,2
25033,2025-03-29,"01,02,08,10,33","10,12",1,2,8,10,33,10,12,54,32,2,3,22,2,0,2,4,0,1,2,0
25034,2025-03-31,"04,15,22,28,33","06,08",4,15,22,28,33,6,8,102,29,2,3,14,2,0,2,1,2,2,1,1
25035,2025-04-02,"22,25,28,29,30","04,08",22,25,28,29,30,4,8,134,8,2,3,12,4,0,2,0,1,4,1,1
25036,2025-04-05,"04,07,13,27,30","02,06",4,7,13,27,30,2,6,81,26,3,2,8,4,0,2,2,1,2,0,2
25037,2025-04-07,"05,20,23,27,31","04,06",5,20,23,27,31,4,6,106,26,4,1,10,2,0,2,1,2,2,0,2
25038,2025-04-09,"07,08,20,26,34","08,09",7,8,20,26,34,8,9,95,27,1,4,17,1,1,1,2,1,2,2,0
25039,2025-04-12,"03,07,14,15,19","06,10",3,7,14,15,19,6,10,58,16,4,1,16,4,0,2,2,3,0,1,1
25040,2025-04-14,"02,08,16,31,32","04,12",2,8,16,31,32,4,12,89,30,1,4,16,8,0,2,2,1,2,1,1
25041,2025-04-16,"03,04,21,22,27","05,11",3,4,21,22,27,5,11,77,24,3,2,16,6,2,0,2,2,1,1,1
25042,2025-04-19,"06,08,11,18,20","05,11",6,8,11,18,20,5,11,63,14,1,4,16,6,2,0,3,2,0,1,1
25043,2025-04-21,"03,16,20,21,27","09,11",3,16,20,21,27,9,11,87,24,3,2,20,2,2,0,1,3,1,2,0
25044,2025-04-23,"15,17,21,22,26","02,08",15,17,21,22,26,2,8,101,11,3,2,10,6,0,2,0,4,1,1,1
25045,2025-04-26,"08,11,21,23,27","03,08",8,11,21,23,27,3,8,90,19,4,1,11,5,1,1,2,2,1,1,1
25046,2025-04-28,"04,10,15,20,34","04,07",4,10,15,20,34,4,7,83,30,1,4,11,3,1,1,2,2,1,1,1
25047,2025-04-30,"03,10,11,12,21","02,03",3,10,11,12,21,2,3,57,18,3,2,5,1,1,1,4,1,0,0,2
25048,2025-05-03,"02,06,17,23,35","06,11",2,6,17,23,35,6,11,83,33,3,2,17,5,1,1,2,2,1,1,1
25049,2025-05-05,"09,20,22,29,34","03,08",9,20,22,29,34,3,8,114,25,2,3,11,5,1,1,1,2,2,1,1
25050,2025-05-07,"15,18,20,21,34","04,10",15,18,20,21,34,4,10,108,19,2,3,14,6,0,2,0,4,1,1,1
25051,2025-05-10,"02,04,13,29,31","05,12",2,4,13,29,31,5,12,79,29,3,2,17,7,1,1,2,1,2,1,1
25052,2025-05-12,"02,04,11,29,30","02,08",2,4,11,29,30,2,8,76,28,2,3,10,6,0,2,3,0,2,1,1
25053,2025-05-14,"14,23,29,30,33","06,12",14,23,29,30,33,6,12,129,19,3,2,18,6,0,2,0,2,3,1,1
25054,2025-05-17,"03,12,16,21,29","01,02",3,12,16,21,29,1,2,81,26,3,2,3,1,1,1,2,2,1,0,2
25055,2025-05-19,"08,10,25,29,30","01,02",8,10,25,29,30,1,2,102,22,2,3,3,1,1,1,2,0,3,0,2
25056,2025-05-21,"12,15,28,29,32","08,11",12,15,28,29,32,8,11,116,20,2,3,19,3,1,1,1,1,3,2,0
25057,2025-05-24,"09,10,11,12,29","01,10",9,10,11,12,29,1,10,71,20,3,2,11,9,1,1,4,0,1,1,1
25058,2025-05-26,"06,11,15,21,23","01,07",6,11,15,21,23,1,7,76,17,4,1,8,6,2,0,2,3,0,1,1
25059,2025-05-28,"03,09,10,11,26","01,02",3,9,10,11,26,1,2,59,23,3,2,3,1,1,1,4,0,1,0,2
25060,2025-05-31,"12,14,19,33,34","01,07",12,14,19,33,34,1,7,112,22,2,3,8,6,2,0,1,2,2,1,1
25061,2025-06-02,"02,11,16,23,28","05,10",2,11,16,23,28,5,10,80,26,2,3,15,5,1,1,2,2,1,1,1
25062,2025-06-04,"14,20,27,28,29","06,10",14,20,27,28,29,6,10,118,15,2,3,16,4,0,2,0,2,3,1,1
25063,2025-06-07,"05,18,26,29,32","07,10",5,18,26,29,32,7,10,110,27,2,3,17,3,1,1,1,1,3,2,0
25064,2025-06-09,"05,10,18,20,34","01,08",5,10,18,20,34,1,8,87,29,1,4,9,7,1,1,2,2,1,1,1
25065,2025-06-11,"07,25,32,33,35","04,09",7,25,32,33,35,4,9,132,28,4,1,13,5,1,1,1,0,4,1,1
25066,2025-06-14,"15,18,27,28,34","03,06",15,18,27,28,34,3,6,122,19,2,3,9,3,1,1,0,2,3,0,2
25067,2025-06-16,"06,10,12,21,22","01,06",6,10,12,21,22,1,6,71,16,1,4,7,5,1,1,3,2,0,0,2
25068,2025-06-18,"01,04,17,20,22","04,10",1,4,17,20,22,4,10,64,21,2,3,14,6,0,2,2,3,0,1,1
25069,2025-06-21,"04,06,07,33,34","09,10",4,6,7,33,34,9,10,84,30,2,3,19,1,1,1,3,0,2,2,0
25070,2025-06-23,"08,09,15,20,22","04,12",8,9,15,20,22,4,12,74,14,2,3,16,8,0,2,2,3,0,1,1
